桌面	zhuōmiàn	1. desktop;2. tabletop
 擲	zhì	1. to toss;2. to throw dice;3. Taiwan pr. [zhi2]
 過時	guòshí	1. old-fashioned;2. out of date;3. to be later than the time stipulated or agreed upon
 孽子	nièzi	1. unfilial son;2. unworthy son;3. illegitimate son;4. concubine's son
 樹幹	shùgàn	1. tree trunk
 怕	pà	1. to be afraid;2. to fear;3. to dread;4. to be unable to endure;5. perhaps
 狗吠	gǒufèi	1. bark;2. CL:聲|声[sheng1];3. to bark
 滾滾	gǔngǔn	1. nickname for a panda;2. to surge on;3. to roll on
 懷胎	huáitāi	1. to become pregnant;2. to carry a child in the womb
 亂糟糟	luànzāozāo	1. chaotic;2. topsy turvy;3. a complete mess
 跳	tiào	1. to jump;2. to hop;3. to skip over;4. to bounce;5. to palpitate
 糞	fèn	1. manure;2. dung
 兩句	liǎngjù	1. (say) a few words
 報曉	bàoxiǎo	1. to herald the break of day
 歌謠	gēyáo	1. folksong;2. ballad;3. nursery rhyme
 那種	nàzhǒng	1. that;2. that kind of;3. that sort of;4. that type of
 午後	wǔhòu	1. afternoon
 這時	zhèshí	1. at this time;2. at this moment
 游動	yóudòng	1. to move about;2. to go from place to place;3. roving;4. mobile
 織布	zhībù	1. woven cloth;2. to weave cloth
 緊緊	jǐnjǐn	1. closely;2. tightly
 兜售	dōushòu	1. to hawk;2. to peddle
 真心實意	zhēnxīnshíyì	1. genuine and sincere (idiom);2. wholehearted
 壓住	yāzhù	1. to press down;2. to crush down;3. to restrain (anger);4. to keep down (voice)
 里	lǐ	1. li, ancient measure of length, approx. 500 m;2. neighborhood;3. ancient administrative unit of 25 families;4. (Tw) borough, administrative unit between the township 鎮|镇[zhen4] and neighborhood 鄰|邻[lin2] levels
 低下	dīxià	1. low status;2. lowly;3. to lower (one's head)
 牛	niú	1. ox;2. cow;3. bull;4. CL:條|条[tiao2],頭|头[tou2];5. newton (abbr. for 牛頓|牛顿[niu2 dun4]);6. (slang) awesome
 請安	qǐngān	1. to pay respects;2. to wish good health;3. in Qing times, a specific form of salutation (see also 打千[da3 qian1])
 打	dǎ	1. dozen (loanword);2. to beat;3. to strike;4. to hit;5. to break;6. to type;7. to mix up;8. to build;9. to fight;10. to fetch;11. to make;12. to tie up;13. to issue;14. to shoot;15. to calculate;16. to play (a game);17. since;18. from
 變得	biàndé	1. to become
 雞	jī	1. fowl;2. chicken;3. CL:隻|只[zhi1];4. (slang) prostitute
 照看	zhàokàn	1. to look after;2. to attend to;3. to have in care
 那個	nàgè	1. that one;2. that thing;3. that (as opposed to this);4. (used before a verb or adjective for emphasis);5. (used to humorously or indirectly refer to sth embarrassing, funny etc, or when one can't think of the right word);6. (used in speech as a filler, similar to "umm", "you know" etc);7. (euph.) menstruation;8. sex;9. also pr. [nei4 ge5]
 長	zhǎng	1. length;2. long;3. forever;4. always;5. constantly;6. chief;7. head;8. elder;9. to grow;10. to develop;11. to increase;12. to enhance
 風聲	fēngshēng	1. sound of the wind;2. rumor;3. talk;4. news;5. reputation
 摸牌	mōpái	1. to draw a tile (at mahjong);2. to play mahjong
 有著	yǒuzhù	1. to have;2. to possess
 撩起	liāoqǐ	1. to raise;2. to lift up (curtains, clothing etc)
 化緣	huàyuán	1. (of a monk) to beg
 揚長而去	yángzhǎngérqù	1. to swagger off;2. to walk off (or drive off etc) without a second thought for those left behind
 黿	yuán	1. sea turtle
 世面	shìmiàn	1. aspects of society;2. the world
 哭喪	kūsàng	1. to wail at a funeral;2. formal wailing while offering sacrifice to the departed
 臭味	chòuwèi	1. bad smell;2. foul odor
 遊玩	yóuwán	1. to amuse oneself;2. to have fun;3. to go sightseeing;4. to take a stroll
 紋絲不動	wénsībùdòng	1. to not move a single jot (idiom)
 遠處	yuǎnchù	1. distant place
 一會	yīhuì	1. a moment;2. a while;3. in a moment;4. also pr. [yi1 hui3]
 起勁	qǐjìn	1. vigorously;2. energetically;3. enthusiastically
 丈人	zhàngrén	1. wife's father (father-in-law);2. old man
 頻頻	pínpín	1. repeatedly;2. again and again;3. continuously;4. constantly
 村莊	cūnzhuāng	1. village;2. hamlet;3. CL:座[zuo4]
 道	dào	1. road;2. path;3. CL:條|条[tiao2],股[gu3];4. principle;5. truth;6. morality;7. reason;8. skill;9. method;10. Dao (of Daoism);11. to say;12. to speak;13. to talk;14. classifier for long thin things (rivers, cracks etc), barriers (walls, doors etc), questions (in an exam etc), commands, courses in a meal, steps in a process;15. (old) circuit (administrative division)
 擋住	dǎngzhù	1. to obstruct
 舀水	yǎoshuǐ	1. to ladle water;2. to scoop up water
 褲襠	kùdāng	1. crotch of trousers
 臉蛋	liǎndàn	1. cheek;2. face
 褲管	kùguǎn	1. trouser leg
 哄笑	hōngxiào	1. to roar with laughter;2. hoots of laughter;3. guffaw
 躲	duǒ	1. to hide;2. to dodge;3. to avoid
 孤身	gūshēn	1. alone;2. lonely
 掙脫	zhēngtuō	1. to throw off;2. to struggle free of;3. Taiwan pr. [zheng1 tuo1]
 爹	diē	1. dad
 一塊	yīkuài	1. one block;2. one piece;3. one (unit of money);4. together;5. in the same place;6. in company
 大肚子	dàdǔzi	1. pregnant;2. potbelly;3. big eater
 一聲	yīshēng	1. first tone in Mandarin (high, level tone)
 身手	shēnshǒu	1. skill;2. talent;3. agility
 喝醉	hēzuì	1. to get drunk
 凶	xiōng	1. vicious;2. fierce;3. ominous;4. inauspicious;5. famine;6. variant of 兇|凶[xiong1]
 那天	nàtiān	1. that day;2. the other day
 飛	fēi	1. to fly
 一次	yīcì	1. first;2. first time;3. once;4. (math.) linear (of degree one)
 城門	chéngmén	1. city gate
 浪蕩	làngdàng	1. to loiter;2. to hang around;3. dissolute;4. licentious
 怔	zhēng	1. to stare blankly;2. startled;3. stumped for words;4. to stare blankly
 逼	bī	1. to force (sb to do sth);2. to compel;3. to press for;4. to extort;5. to press on towards;6. to press up to;7. to close in on;8. euphemistic variant of 屄[bi1]
 心想	xīnxiǎng	1. to think to oneself;2. to think;3. to assume
 犯愁	fànchóu	1. to worry;2. to be anxious
 讓位	ràngwèi	1. to abdicate;2. to yield
 坐下	zuòxià	1. to sit down
 稀奇	xīqí	1. rare;2. strange
 安分	ānfèn	1. content with one's lot;2. knowing one's place
 聽話	tīnghuà	1. to do what one is told;2. obedient
 頂撞	dǐngzhuàng	1. to contradict (elders or superiors)
 泥巴	níbā	1. mud
 田埂	tiángěng	1. embankment or foothpath between paddy fields
 十有八九	shíyǒubājiǔ	1. most likely;2. mostly (in 8 or 9 cases out of 10);3. vast majority
 們	men	1. plural marker for pronouns, and nouns referring to individuals
 娘	niáng	1. mother;2. young lady;3. (coll.) effeminate
 手電	shǒudiàn	1. flashlight;2. torch
 賞心悅目	shǎngxīnyuèmù	1. warms the heart and delights the eye (idiom);2. pleasing;3. delightful
 過	guò	1. to cross;2. to go over;3. to pass (time);4. to celebrate (a holiday);5. to live;6. to get along;7. excessively;8. too-;9. (experienced action marker)
 賭注	dǔzhù	1. stake (in a gamble);2. (what is at) stake
 草帽	cǎomào	1. straw hat
 幾次	jǐcì	1. several times
 前	qián	1. front;2. forward;3. ahead;4. first;5. top (followed by a number);6. future;7. ago;8. before;9. BC (e.g. 前293年);10. former;11. formerly
 草鞋	cǎoxié	1. straw sandals
 河水	héshuǐ	1. river water
 好事	hǎoshì	1. good action, deed, thing or work (also sarcastic, "a fine thing indeed");2. charity;3. happy occasion;4. Daoist or Buddhist ceremony for the souls of the dead;5. to be meddlesome
 學時	xuéshí	1. class hour;2. period
 跑	pǎo	1. (of an animal) to paw (the ground);2. to run;3. to run away;4. to escape;5. to run around (on errands etc);6. (of a gas or liquid) to leak or evaporate;7. (verb complement) away;8. off
 路途遙遠	lùtúyáoyuǎn	1. distant;2. far-flung
 鴨子	yāzi	1. duck;2. male prostitute (slang)
 幾個	jǐgè	1. a few;2. several;3. how many
 天剛亮	tiāngāngliàng	1. daybreak
 見	jiàn	1. to see;2. to meet;3. to appear (to be sth);4. to interview;5. to appear;6. also written 現|现[xian4]
 做生意	zuòshēngyì	1. to do business
 走過	zǒuguò	1. to walk past;2. to pass by
 走近	zǒujìn	1. to approach;2. to draw near to
 青樓	qīnglóu	1. (literary) brothel;2. pleasure quarters
 只	zhǐ	1. only;2. merely;3. just;4. but
 手腳	shǒujiǎo	1. hand and foot;2. movement of limbs;3. action;4. trick;5. step in a procedure (CL: 道[dao4])
 見到	jiàndào	1. to see
 起	qǐ	1. to rise;2. to raise;3. to get up;4. to set out;5. to start;6. to appear;7. to launch;8. to initiate (action);9. to draft;10. to establish;11. to get (from a depot or counter);12. verb suffix, to start;13. starting from (a time, place, price etc);14. classifier for occurrences or unpredictable events: case, instance;15. classifier for groups: batch, group
 沒	méi	1. (negative prefix for verbs);2. have not;3. not;4. drowned;5. to end;6. to die;7. to inundate
 會長	huìzhǎng	1. president of a club, committee etc
 左思右想	zuǒsīyòuxiǎng	1. to turn over in one's mind (idiom); to think through from different angles;2. to ponder
 拍手	pāishǒu	1. to clap one's hands
 偷雞摸狗	tōujīmōgǒu	1. to imitate the dog and steal chicken (idiom);2. to pilfer;3. to dally with women;4. to have affairs
 把頭	bǎtóu	1. labor contractor;2. gangmaster
 定	dìng	1. to set;2. to fix;3. to determine;4. to decide;5. to order
 一頭	yītóu	1. one head;2. a head full of sth;3. one end (of a stick);4. one side;5. headlong;6. directly;7. rapidly;8. simultaneously
 風騷	fēngsāo	1. literary excellence;2. flirtatious behavior
 女婿	nǚxù	1. daughter's husband;2. son-in-law
 兩旁	liǎngpáng	1. both sides;2. either side
 鶚	è	1. (bird species of China) western osprey (Pandion haliaetus)
 洗牌	xǐpái	1. to shuffle cards
 佃戶	diànhù	1. tenant farmer
 旗	qí	1. banner;2. flag;3. (in Qing times) Manchu (cf. 八旗[Ba1 qi2]);4. administrative subdivision in inner Mongolia equivalent to 縣|县[xian4] county;5. CL:面[mian4]
 存心	cúnxīn	1. deliberately
 來到	láidào	1. to come;2. to arrive
 談情說愛	tánqíngshuōài	1. to murmur endearments (idiom);2. to get into a romantic relationship
 因	yīn	1. cause;2. reason;3. because
 低頭	dītóu	1. to bow the head;2. to yield;3. to give in
 拜佛	bàifó	1. to worship Buddha
 布鞋	bùxié	1. cloth shoes;2. CL:雙|双[shuang1],隻|只[zhi1]
 鑽	zuān	1. to drill;2. to bore;3. to get into;4. to make one's way into;5. to enter (a hole);6. to thread one's way through;7. to study intensively;8. to dig into;9. to curry favor for personal gain;10. an auger;11. diamond
 凸起	tūqǐ	1. convex;2. protruding;3. to protrude;4. to bulge;5. to buckle upwards
 麻將	májiāng	1. mahjong;2. CL:副[fu4]
 只能	zhǐnéng	1. can only;2. obliged to do sth;3. to have no other choice
 幫	bāng	1. to help;2. to assist;3. to support;4. for sb (i.e. as a help);5. hired (as worker);6. side (of pail, boat etc);7. outer layer;8. upper (of a shoe);9. group;10. gang;11. clique;12. party;13. secret society
 衣衫	yīshān	1. clothing;2. unlined garment
 和尚	héshàng	1. Buddhist monk
 有錢人	yǒuqiánrén	1. rich person;2. the rich
 悄聲	qiāoshēng	1. quietly;2. in a low voice
 門檻	ménkǎn	1. doorstep;2. sill;3. threshold;4. fig. knack or trick (esp. scheme to get sth cheaper)
 訓斥	xùnchì	1. to reprimand;2. to rebuke;3. to berate;4. stern criticism
 心腸	xīncháng	1. heart;2. intention;3. one's inclination;4. state of mind;5. to have the heart for sth;6. mood
 推說	tuīshuō	1. to plead;2. to claim as an excuse
 牌九	páijiǔ	1. pai gow (gambling game played with dominoes)
 揪住	jiūzhù	1. to grab
 隻	zhī	1. classifier for birds and certain animals, one of a pair, some utensils, vessels etc
 叫醒	jiàoxǐng	1. to awaken;2. to wake sb up;3. to rouse
 大雨	dàyǔ	1. heavy rain;2. CL:場|场[chang2]
 犁	lí	1. plow
 竊竊	qièqiè	1. privately;2. secretly;3. unobtrusively
 說白了	shuōbáile	1. to speak frankly
 做出	zuòchū	1. to put out;2. to issue
 蔣介石	jiǎngjièshí	1. Chiang Kai-shek (1887-1975), military leader, head of the Nationalist government in China 1928-1949 and the government in exile on Taiwan 1950-1975
 債主	zhàizhǔ	1. creditor
 拖	tuō	1. to drag;2. to tow;3. to trail;4. to hang down;5. to mop (the floor);6. to delay;7. to drag on
 免不了	miǎnbùliǎo	1. unavoidable;2. can't be avoided
 擺弄	bǎinòng	1. to move back and forth;2. to fiddle with
 家境	jiājìng	1. family financial situation;2. family circumstances
 黑桃	hēitáo	1. spade ♠ (in card games)
 袖管	xiùguǎn	1. sleeve
 編著	biānzhù	1. to compile;2. to write
 一身	yīshēn	1. whole body;2. from head to toe;3. single person;4. a suit of clothes
 抬	tái	1. to lift;2. to raise;3. (of two or more persons) to carry
 這麼	zhème	1. so much;2. this much;3. how much?;4. this way;5. like this
 腳丫子	jiǎoyāzi	1. (coll.) foot
 瞇	mī	1. to narrow one's eyes;2. to squint;3. (dialect) to take a nap
 賭局	dǔjú	1. game of chance;2. gambling party;3. gambling joint
 敗家子	bàijiāzi	1. spendthrift;2. wastrel;3. prodigal
 不孝	bùxiào	1. unfilial
 支支吾吾	zhīzhīwúwú	1. to hem and haw;2. to stall;3. to stammer;4. to mumble;5. to falter
 金	jīn	1. Jurchen Jin dynasty (1115-1234);2. gold;3. chemical element Au;4. generic term for lustrous and ductile metals;5. money;6. golden;7. highly respected;8. one of the eight categories of ancient musical instruments 八音[ba1 yin1]
 打鼓	dǎgǔ	1. to beat a drum;2. to play a drum;3. (fig.) to feel nervous
 卻是	quèshì	1. nevertheless;2. actually;3. the fact is ...
 搔癢	sāoyǎng	1. to scratch (an itch);2. to tickle
 茶水	cháshuǐ	1. tea prepared in large quantity using inexpensive tea leaves
 照射	zhàoshè	1. to shine on;2. to light up;3. to irradiate
 該	gāi	1. should;2. ought to;3. probably;4. must be;5. to deserve;6. to owe;7. to be sb's turn to do sth;8. that;9. the above-mentioned
 夥計	huǒjì	1. variant of 伙計|伙计[huo3 ji5]
 停下	tíngxià	1. to stop
 筆直	bǐzhí	1. perfectly straight;2. straight as a ramrod;3. bolt upright
 二流子	èrliúzi	1. loafer;2. idler;3. bum
 有生以來	yǒushēngyǐlái	1. since birth;2. for one's whole life
 對	duì	1. right;2. correct;3. couple;4. pair;5. towards;6. at;7. for;8. to face;9. opposite;10. to treat (sb a certain way);11. to match together;12. to adjust;13. to fit;14. to suit;15. to answer;16. to reply;17. classifier: couple
 唱	chàng	1. to sing;2. to call loudly;3. to chant
 八月	bāyuè	1. August;2. eighth month (of the lunar year)
 賊亮	zéiliàng	1. bright;2. shiny;3. dazzling;4. glaring
 失聲	shīshēng	1. to lose one's voice;2. (to cry out) involuntarily
 作	zuò	1. worker;2. workshop;3. (slang) troublesome;4. high-maintenance (person);5. to do;6. to grow;7. to write or compose;8. to pretend;9. to regard as;10. to feel;11. writings or works
 聊	liáo	1. to chat;2. to depend upon (literary);3. temporarily;4. just;5. slightly
 半晌	bànshǎng	1. half of the day;2. a long time;3. quite a while
 南腔北調	nánqiāngběidiào	1. a regional accent
 黝黑	yǒuhēi	1. dark;2. black;3. suntanned
 離去	líqù	1. to leave;2. to exit
 乾	qián	1. one of the Eight Trigrams 八卦[ba1 gua4], symbolizing heaven;2. male principle;3. ☰;4. ancient Chinese compass point: 315° (northwest);5. dry;6. clean;7. in vain;8. dried food;9. foster;10. adoptive;11. to ignore
 可不	kěbù	1. see 可不是[ke3 bu5 shi4]
 老爺	lǎoyé	1. (respectful) lord;2. master;3. (coll.) maternal grandfather
 一聲不吭	yīshēngbùkēng	1. to not say a word
 青草	qīngcǎo	1. grass
 後	hòu	1. back;2. behind;3. rear;4. afterwards;5. after;6. later;7. post-
 額頭	étóu	1. forehead
 可	kě	1. can;2. may;3. able to;4. to approve;5. to permit;6. to suit;7. (particle used for emphasis) certainly;8. very;9. see 可汗[ke4 han2]
 知	zhī	1. to know;2. to be aware
 軟硬不吃	ruǎnyìngbùchī	1. unmoved by force or persuasion
 神色	shénsè	1. expression;2. look
 還	hái	1. still;2. still in progress;3. still more;4. yet;5. even more;6. in addition;7. fairly;8. passably (good);9. as early as;10. even;11. also;12. else;13. to pay back;14. to return
 散漫	sǎnmàn	1. undisciplined;2. unorganized
 講述	jiǎngshù	1. to talk about;2. to narrate;3. to give an account
 羞怯	xiūqiè	1. shy;2. timid
 不可救藥	bùkějiùyào	1. incurable;2. incorrigible;3. beyond cure;4. hopeless
 屎	shǐ	1. stool;2. feces;3. ear wax;4. nasal mucus
 身後	shēnhòu	1. posthumous;2. one's social background;3. behind the body
 縫	fèng	1. to sew;2. to stitch;3. seam;4. crack;5. narrow slit;6. CL:道[dao4]
 短褲	duǎnkù	1. short pants;2. shorts
 自古	zìgǔ	1. (since) ancient times;2. (from) time immemorial
 腰板	yāobǎn	1. waist and back;2. fig. upright and still healthy
 幾年	jǐnián	1. a few years;2. several years;3. how many years
 一句	yījù	1. a line of verse;2. a sentence
 牌	pái	1. mahjong tile;2. playing card;3. game pieces;4. signboard;5. plate;6. tablet;7. medal;8. CL:片[pian4],個|个[ge4],塊|块[kuai4]
 逃竄	táocuàn	1. to run away;2. to flee in disarray
 水邊	shuǐbiān	1. edge of the water;2. waterside;3. shore (of sea, lake or river)
 香火	xiānghuǒ	1. incense burning in front of a temple;2. burning joss sticks
 跑堂	pǎotáng	1. waiter (old)
 田產	tiánchǎn	1. estate;2. lands
 搶先	qiǎngxiān	1. to rush (to do sth urgent);2. to try to be the first;3. to forestall
 滿不在乎	mǎnbùzàihu	1. not in the least concerned (idiom);2. reckless;3. couldn't give a damn about it;4. unperturbed;5. couldn't care less;6. harum scarum
 耕田	gēngtián	1. to cultivate soil;2. to till fields
 村舍	cūnshè	1. cottage
 嘩嘩	huāhuā	1. sound of gurgling water
 干	gàn	1. to concern;2. to interfere;3. shield;4. stem
 鬼混	guǐhùn	1. to hang around;2. to fool around;3. to live aimlessly
 水面	shuǐmiàn	1. water surface
 嗓音	sǎngyīn	1. voice
 嘟嘟噥噥	dūdūnóngnóng	1. to mumble in whispers;2. to mutter to oneself
 坑坑窪窪	kēngkēngwāwā	1. bumpy;2. full of potholes
 賭徒	dǔtú	1. gambler
 河邊	hébiān	1. river bank
 酸曲	suānqū	1. love song
 捂	wǔ	1. to enclose;2. to cover with the hand (one's eyes, nose or ears);3. to cover up (an affair);4. contrary;5. to contradict
 沉不住氣	chénbúzhùqì	1. to lose one's cool;2. to get impatient;3. unable to remain calm
 手氣	shǒuqì	1. luck (in gambling)
 踢	tī	1. to kick;2. to play (e.g. soccer);3. (slang) butch (in a lesbian relationship)
 撒尿	sāniào	1. to pass water;2. to piss;3. to urinate;4. to wee wee
 敲打	qiāodǎ	1. to beat sb;2. to beat (a drum)
 十月	shíyuè	1. October;2. tenth month (of the lunar year)
 才	cái	1. ability;2. talent;3. sb of a certain type;4. a capable individual;5. only;6. only then;7. just now
 撓癢癢	náoyǎngyǎng	1. to tickle
 走出	zǒuchū	1. to leave (a room etc);2. to go out through (a door etc)
 嘴裡	zuǐlǐ	1. mouth;2. in the mouth;3. on one's lips;4. speech;5. words
 雙手	shuāngshǒu	1. both hands
 清點	qīngdiǎn	1. to check;2. to make inventory
 栽	zāi	1. to grow;2. to plant;3. to insert;4. to force on sb;5. to fall head first
 天	tiān	1. day;2. sky;3. heaven
 第一次	dìyīcì	1. the first time;2. first;3. number one
 車輪	chēlún	1. wheel
 鄉間	xiāngjiān	1. in the country;2. rural;3. pastoral
 事	shì	1. matter;2. thing;3. item;4. work;5. affair;6. CL:件[jian4],樁|桩[zhuang1],回[hui2]
 整天	zhěngtiān	1. all day long;2. whole day
 進城	jìnchéng	1. to go to town;2. to enter a big city (to live or work)
 欲	yù	1. to wish for;2. to desire;3. variant of 慾|欲[yu4]
 飯	fàn	1. cooked rice;2. CL:碗[wan3];3. meal;4. CL:頓|顿[dun4];5. (loanword) fan;6. devotee
 手裡	shǒulǐ	1. in hand;2. (a situation is) in sb's hands
 野地	yěde	1. wilderness
 叫喚	jiàohuàn	1. to cry out;2. to bark out a sound
 每天	měitiān	1. every day;2. everyday
 女人家	nǚrénjiā	1. women (in general)
 花花綠綠	huāhuālǜlǜ	1. brightly colored;2. gaudy
 擠滿	jǐmǎn	1. crowded to bursting point;2. filled to overflowing;3. jam-packed
 沉睡	chénshuì	1. to be fast asleep;2. (fig.) to lie dormant;3. to lie undiscovered
 是不是	shìbúshì	1. is or isn't;2. yes or no;3. whether or not
 聲	shēng	1. sound;2. voice;3. tone;4. noise;5. reputation;6. classifier for sounds
 已	yǐ	1. already;2. to stop;3. then;4. afterwards
 蒸騰	zhēngténg	1. (of a vapor etc) to rise;2. to hang in the air
 長衫	zhǎngshān	1. long gown;2. cheongsam;3. traditional Asian dress for men or (in Hong Kong) women's qipao
 那時	nàshí	1. then;2. at that time;3. in those days
 扶犁	fúlí	1. to put one's hand to the plow
 細聲細氣	xìshēngxìqì	1. in a fine voice (idiom); softly spoken
 前世	qiánshì	1. previous generations;2. previous incarnation (Buddhism)
 慢吞吞	màntūntūn	1. very slow;2. exasperatingly slow
 泥鰍	níqiū	1. loach;2. mud fish;3. CL:條|条[tiao2]
 一點	yīdiǎn	1. a bit;2. a little;3. one dot;4. one point
 拍打	pāidǎ	1. to pat;2. to slap;3. (of a bird) to flap (one's wings)
 水壺	shuǐhú	1. kettle;2. canteen;3. watering can
 咧	liě	1. see 咧咧[lie1 lie1];2. to draw back the corners of one's mouth;3. modal particle expressing exclamation
 商會	shānghuì	1. chamber of commerce
 打盹	dǎdǔn	1. to doze off
 常	cháng	1. always;2. ever;3. often;4. frequently;5. common;6. general;7. constant
 起先	qǐxiān	1. at first;2. in the beginning
 樹梢	shùshāo	1. the tip of a tree;2. treetop
 歌詞	gēcí	1. song lyric;2. lyrics
 近前	jìnqián	1. to come close;2. to get near to;3. front
 整夜	zhěngyè	1. the whole night;2. all through the night
 信口開河	xìnkǒukāihé	1. to speak without thinking (idiom);2. to blurt sth out
 妻	qī	1. wife;2. to marry off (a daughter)
 少爺	shǎoyé	1. son of the boss;2. young master of the house;3. your son (honorific)
 舊日	jiùrì	1. former times;2. olden days
 招	zhāo	1. to recruit;2. to provoke;3. to beckon;4. to incur;5. to infect;6. contagious;7. a move (chess);8. a maneuver;9. device;10. trick;11. to confess
 這天	zhètiān	1. today;2. this day
 噢	ō	1. Oh!
 露出	lùchū	1. to expose;2. to show;3. also pr. [lou4 chu1]
 手心	shǒuxīn	1. palm (of one's hand);2. control (extended meaning from having something in the palm of one's hand)
 心裡	xīnlǐ	1. chest;2. heart;3. mind
 走開	zǒukāi	1. to leave;2. to walk away;3. to beat it;4. to move aside
 滯	zhì	1. sluggish
 摘下	zhāixià	1. to take off;2. to remove (one's hat, a door from its hinges etc);3. to pick (a piece of fruit from a tree etc);4. (sports) to pick off (a rebound etc)
 缸	gāng	1. jar;2. vat;3. classifier for loads of laundry;4. CL:口[kou3]
 肥碩	féishuò	1. fleshy (fruit);2. plump;3. large and firm-fleshed (limbs, body);4. stout
 骰子	tóuzǐ	1. dice
 茶垢	chágòu	1. tea stain (on the inside of a tea pot, tea cup etc)
 粗啞	cūyǎ	1. husky;2. hoarse;3. raucous
 帳目	zhàngmù	1. account
 當上	dāngshàng	1. to take up duty as;2. to assume a position;3. to assume;4. to take on (an office)
 眉開眼笑	méikāiyǎnxiào	1. brows raised in delight, eyes laughing (idiom); beaming with joy;2. all smiles
 二來	èrlái	1. secondly, ...
 認輸	rènshū	1. to concede;2. to admit defeat
 旁	páng	1. beside;2. one side;3. other;4. side;5. self;6. the right-hand side of split Chinese character, often the phonetic
 脊背	jǐbèi	1. back (of a human or other vertebrate)
 苦根	kǔgēn	1. underlying cause of poverty
 罵罵咧咧	màmàliēliē	1. to swear while talking;2. to be foul-mouthed
 笑盈盈	xiàoyíngyíng	1. smilingly;2. to be all smiles
 彷彿	pángfú	1. to seem;2. as if;3. alike;4. similar
 雷公	léigōng	1. Lei Gong or Duke of Thunder, the God of Thunder in Chinese mythology
 乇	tuō	1. archaic variant of 托[tuo1];2. "blade of grass" component in Chinese characters
 釘子	dīngzi	1. nail;2. snag;3. saboteur
 贏家	yíngjiā	1. winner
 勾當	gōudāng	1. shady business
 頭巾	tóujīn	1. cloth head covering worn by men in ancient times;2. headscarf (typically worn by women);3. kerchief;4. turban
 豬肉	zhūròu	1. pork
 偷偷	tōutōu	1. stealthily;2. secretly;3. covertly;4. furtively;5. on the sly
 動	dòng	1. (of sth) to move;2. to set in movement;3. to displace;4. to touch;5. to make use of;6. to stir (emotions);7. to alter;8. abbr. for 動詞|动词[dong4 ci2], verb
 鬧騰	nàoténg	1. to disturb;2. to create confusion;3. to make a din
 扯	chě	1. to pull;2. to tear;3. (of cloth, thread etc) to buy;4. to chat;5. to gossip;6. (coll.) (Tw) ridiculous;7. hokey
 有氣無力	yǒuqìwúlì	1. weakly and without strength (idiom); dispirited
 苦味	kǔwèi	1. bitter taste;2. bitterness
 汗水	hànshuǐ	1. sweat;2. perspiration
 屢見不鮮	lǚjiànbùxiān	1. a common occurrence (idiom)
 妓院	jìyuàn	1. brothel;2. whorehouse
 大錢	dàqián	1. high denomination of banknotes or coins;2. lots of money;3. a big sum (e.g. a bribe)
 閉著	bìzhù	1. closed
 幹活	gànhuó	1. to work;2. to be employed
 遊蕩	yóudàng	1. to wander;2. to roam about;3. to loaf about;4. to be idle
 止	zhǐ	1. to stop;2. to prohibit;3. until;4. only
 女孩	nǚhái	1. girl;2. lass
 握住	wòzhù	1. to grip;2. to hold
 中	zhōng	1. China;2. Chinese;3. within;4. among;5. in;6. middle;7. center;8. while (doing sth);9. during;10. (dialect) OK;11. all right;12. to hit (the mark);13. to be hit by;14. to suffer;15. to win (a prize, a lottery)
 堵	dǔ	1. to block up (a road, pipe etc);2. to stop up (a hole);3. (fig.) (of a person) choked up with anxiety or stress;4. wall (literary);5. (classifier for walls)
 小道	xiǎodào	1. bypath;2. trail;3. bribery as a means of achieving a goal;4. minor arts (Confucian reference to agriculture, medicine, divination, and other professions unworthy of a gentleman)
 正文	zhèngwén	1. main text (as opposed to footnotes);2. main body (of a book)
 輸給	shūgěi	1. to lose to (sb);2. to be outdone by
 無恙	wúyàng	1. in good health
 檢點	jiǎndiǎn	1. to examine;2. to check;3. to keep a lookout;4. cautious;5. restrained (in speech or mannerisms)
 透亮	tòuliàng	1. bright;2. shining;3. translucent;4. crystal clear
 嘰嘰喳喳	jījīzhāzhā	1. (onom.) chirp;2. twitter;3. buzzing;4. to chatter continuously
 起身	qǐshēn	1. to get up;2. to leave;3. to set forth
 爪子	zhuǎzǐ	1. (animal's) claw
 開脫	kāituō	1. to exculpate;2. to absolve;3. to exonerate
 赤裸	chìluǒ	1. naked;2. bare
 不好	bùhǎo	1. no good
 不願	bùyuàn	1. unwilling;2. unwillingness
 昏昏沉沉	hūnhūnchénchén	1. dizzy
 松花蛋	sōnghuādàn	1. thousand-year egg;2. preserved egg
 一口	yīkǒu	1. readily;2. flatly (deny, admit and so on);3. a mouthful;4. a bite
 轉彎抹角	zhuǎnwānmǒjiǎo	1. see 拐彎抹角|拐弯抹角[guai3 wan1 mo4 jiao3]
 嘻嘻	xīxī	1. hee hee;2. happy
 不能	bùnéng	1. cannot;2. must not;3. should not
 有人	yǒurén	1. someone;2. people;3. anyone;4. there is someone there;5. occupied (as in restroom)
 氣	qì	1. gas;2. air;3. smell;4. weather;5. to make angry;6. to annoy;7. to get angry;8. vital energy;9. qi
 各不相同	gèbùxiāngtóng	1. to have nothing in common with each other (idiom)
 項圈	xiàngquān	1. necklace
 撐	chēng	1. to support;2. to prop up;3. to push or move with a pole;4. to maintain;5. to open or unfurl;6. to fill to bursting point;7. brace;8. stay;9. support
 好端端	hǎoduānduān	1. perfectly all right;2. without rhyme or reason
 喊叫	hǎnjiào	1. to cry out;2. to shout
 衣	yī	1. clothes;2. CL:件[jian4];3. Kangxi radical 145;4. to dress;5. to wear;6. to put on (clothes)
 爬	pá	1. to crawl;2. to climb;3. to get up or sit up
 嫖妓	piáojì	1. to visit a prostitute
 和龍	hélóng	1. Helong county level city in Yanbian Korean autonomous prefecture 延邊朝鮮族自治州|延边朝鲜族自治州, Jilin
 捲起	juǎnqǐ	1. to roll up;2. to curl up;3. (of dust etc) to swirl up
 鐘	zhōng	1. clock;2. o'clock;3. time as measured in hours and minutes;4. bell;5. CL:架[jia4],座[zuo4]
 嫌棄	xiánqì	1. to avoid sb (out of dislike);2. to turn one's back on sb;3. to ignore
 饞嘴	chánzuǐ	1. gluttonous;2. glutton
 半月	bànyuè	1. half-moon;2. fortnight
 吆喝	yāohe	1. to shout;2. to bawl;3. to yell (to urge on an animal);4. to hawk (one's wares);5. to denounce loudly;6. to shout slogans
 抖動	dǒudòng	1. to tremble
 另	lìng	1. other;2. another;3. separate;4. separately
 聲響	shēngxiǎng	1. sound;2. noise
 點數	diǎnshù	1. to count and check;2. to tally;3. points (collected in some bonus scheme etc)
 名叫	míngjiào	1. called;2. named
 打呵欠	dǎhēqiàn	1. to yawn
 激昂	jīáng	1. impassioned;2. worked up
 從來不	cóngláibù	1. never
 天色	tiānsè	1. color of the sky;2. time of day, as indicated by the color of the sky;3. weather
 唷	yō	1. (interjection expressing surprise) Oh!;2. My!;3. final particle expressing exhortation, admiration etc
 揖	yī	1. to greet by raising clasped hands
 喘	chuǎn	1. to gasp;2. to pant;3. asthma
 不會	bùhuì	1. improbable;2. unlikely;3. will not (act, happen etc);4. not able;5. not having learned to do sth;6. (coll.) (Tw) don't mention it;7. not at all
 逆來順受	nìláishùnshòu	1. to resign oneself to adversity (idiom); to grin and bear it;2. to submit meekly to insults, maltreatment, humiliation etc
 轎子	jiàozi	1. sedan chair;2. palanquin;3. litter
 兒媳	érxí	1. daughter-in-law
 壓	yā	1. to press;2. to push down;3. to keep under (control);4. pressure;5. see 壓根兒|压根儿[ya4 gen1 r5]
 銀元	yínyuán	1. flat silver (former coinage);2. also written 銀圓|银圆;3. silver dollar
 這位	zhèwèi	1. this (person)
 耗子	hàozi	1. (dialect) mouse;2. rat
 妓女	jìnǚ	1. prostitute;2. hooker
 酒	jiǔ	1. wine (esp. rice wine);2. liquor;3. spirits;4. alcoholic beverage;5. CL:杯[bei1],瓶[ping2],罐[guan4],桶[tong3],缸[gang1]
 傳來	chuánlái	1. (of a sound) to come through;2. to be heard;3. (of news) to arrive
 慢悠悠	mànyōuyōu	1. unhurried
 手	shǒu	1. hand;2. (formal) to hold;3. person engaged in certain types of work;4. person skilled in certain types of work;5. personal(ly);6. convenient;7. classifier for skill;8. CL:雙|双[shuang1],隻|只[zhi1]
 每次	měicì	1. every time
 輪	lún	1. wheel;2. disk;3. ring;4. steamship;5. to take turns;6. to rotate;7. by turn;8. classifier for big round objects: disk, or recurring events: round, turn
 得	dé	1. to obtain;2. to get;3. to gain;4. to catch (a disease);5. proper;6. suitable;7. proud;8. contented;9. to allow;10. to permit;11. ready;12. finished;13. structural particle: used after a verb (or adjective as main verb), linking it to following phrase indicating effect, degree, possibility etc;14. to have to;15. must;16. ought to;17. to need to
 滿腹	mǎnfù	1. filled with;2. preoccupied with
 算計	suànjì	1. to reckon;2. to calculate;3. to plan;4. to expect;5. to scheme
 翻動	fāndòng	1. to flip over;2. to turn (a page);3. to scroll (an electronic document);4. to stir (food in a pot etc);5. to move things about;6. to rummage
 活著	huózhù	1. alive
 穿著	chuānzhù	1. attire;2. clothes;3. dress
 沿	yán	1. along;2. to follow (a line, tradition etc);3. to carry on;4. to trim (a border with braid, tape etc);5. border;6. edge
 挖	wā	1. to dig;2. to excavate;3. to scoop out
 摔	shuāi	1. to throw down;2. to fall;3. to drop and break
 將	jiāng	1. will;2. shall;3. to use;4. to take;5. to checkmate;6. just a short while ago;7. (introduces object of main verb, used in the same way as 把[ba3]);8. general;9. commander-in-chief (military);10. king (chess piece);11. to command;12. to lead;13. to desire;14. to invite;15. to request
 村子	cūnzi	1. village
 煙囪	yāncōng	1. chimney
 彩旗	cǎiqí	1. colored flag
 引子	yǐnzi	1. introduction;2. primer;3. opening words
 茶碗	cháwǎn	1. teacup
 農忙	nóngmáng	1. busy farming season
 走進	zǒujìn	1. to enter
 深感	shēngǎn	1. to feel deeply
 帶有	dàiyǒu	1. to have;2. to involve
 千字文	qiānzìwén	1. Thousand Character Classic, 6th century poem used as a traditional reading primer
 嘿嘿	hēihēi	1. (onom.) he he;2. mischievous laughter
 差一點	chàyīdiǎn	1. see 差點|差点[cha4 dian3]
 慢慢	mànmàn	1. slowly
 胡鬧	húnào	1. to act willfully and make a scene;2. to make trouble
 呼哧呼哧	hūchīhūchī	1. (onom.) rapid breathing
 一眼	yīyǎn	1. a glance;2. a quick look;3. a glimpse
 逃之夭夭	táozhīyāoyāo	1. to escape without trace (idiom); to make one's getaway (from the scene of a crime);2. to show a clean pair of heels
 回到	huídào	1. to return to
 暗地	àndì	1. secretly;2. inwardly
 岳父	yuèfù	1. wife's father, father-in-law
 睡	shuì	1. to sleep;2. to lie down
 青筋	qīngjīn	1. veins;2. blue veins
 亮光	liàngguāng	1. light;2. beam of light;3. gleam of light;4. light reflected from an object
 一個個	yīgègè	1. each and every one
 抹	mǒ	1. to wipe;2. to smear;3. to wipe;4. to erase;5. classifier for wisps of cloud, light-beams etc;6. to plaster;7. to go around;8. to skirt
 這個	zhègè	1. this;2. this one
 扯住	chězhù	1. to grasp firmly
 古板	gǔbǎn	1. outmoded;2. old-fashioned;3. inflexible
 私塾	sīshú	1. private school (in former times)
 敗落	bàiluò	1. (of status or wealth) to decline;2. (of buildings etc) to become dilapidated;3. run-down;4. (of plants) to wilt
 貓眼	māoyǎn	1. peephole;2. chrysoberyl
 好好	hǎohǎo	1. well;2. carefully;3. nicely;4. properly
 拉屎	lāshǐ	1. to defecate;2. to shit;3. to crap
 呵欠	hēqiàn	1. yawn
 看上去	kànshàngqù	1. it would appear;2. it seems (that)
 舒坦	shūtǎn	1. comfortable;2. at ease
 雇	gù	1. to employ;2. to hire;3. to rent
 偷聽	tōutīng	1. to eavesdrop;2. to monitor (secretly)
 唰	shuā	1. (onom.) swishing;2. rustling
 其間	qíjiān	1. in between;2. within that interval;3. in the meantime
 蛋	dàn	1. variant of 蜑[Dan4];2. egg;3. CL:個|个[ge4],打[da2];4. oval-shaped thing
 輕輕	qīngqīng	1. lightly;2. softly
 動彈不得	dòngdànbùdé	1. to be unable to move a single step
 珍	zhēn	1. precious thing;2. treasure;3. culinary delicacy;4. rare;5. valuable;6. to value highly
 瓜	guā	1. melon;2. gourd;3. squash
 不是	búshì	1. fault;2. blame;3. no;4. is not;5. not
 嗚嗚	wūwū	1. (interj) boo hoo
 鼻青眼腫	bíqīngyǎnzhǒng	1. a black eye (idiom); serious injury to the face;2. fig. a setback;3. a defeat
 輸掉	shūdiào	1. to lose
 一家	yījiā	1. the whole family;2. the same family;3. the family ... (when preceded by a family name);4. group
 如	rú	1. as;2. as if;3. such as
 自鳴得意	zìmíngdéyì	1. to think highly of oneself
 青天白日	qīngtiānbáirì	1. in broad daylight;2. in the middle of the day;3. KMT emblem, a white sun on a blue background
 半個	bàngè	1. half of sth
 湊	còu	1. to gather together, pool or collect;2. to happen by chance;3. to move close to;4. to exploit an opportunity
 哭聲	kūshēng	1. sound of weeping
 等	děng	1. class;2. rank;3. grade;4. equal to;5. same as;6. to wait for;7. to await;8. et cetera;9. and so on;10. et al. (and other authors);11. after;12. as soon as;13. once
 賭	dǔ	1. to bet;2. to gamble
 吃喝嫖賭	chīhēpiáodǔ	1. to go dining, wining, whoring and gambling;2. to lead a life of dissipation
 樹蔭	shùyīn	1. shade of a tree
 嫖	piáo	1. to visit a prostitute
 時	shí	1. o'clock;2. time;3. when;4. hour;5. season;6. period
 光耀	guāngyào	1. dazzling;2. brilliant
 櫃檯	guìtái	1. sales counter;2. front desk;3. bar;4. (of markets, medicines etc) OTC (over-the-counter)
 鹹菜	xiáncài	1. salted vegetables;2. pickles
 更為	gèngwèi	1. even more
 闊	kuò	1. rich;2. wide;3. broad
 說道	shuōdào	1. to state;2. to say (the quoted words);3. to discuss;4. reason (behind sth)
 收復失地	shōufùshīdì	1. to recover lost territory
 沒趣	méiqù	1. embarrassing;2. dull;3. unsatisfactory
 巴掌	bāzhǎng	1. palm of the hand;2. classifier: slap
 吃喝	chīhē	1. to eat and drink;2. food and drink
 床邊	chuángbiān	1. bedside
 抬起	táiqǐ	1. to lift up
 賒帳	shēzhàng	1. see 賒賬|赊账[she1 zhang4]
 亮出	liàngchū	1. to suddenly reveal;2. to flash (one's ID, a banknote etc)
 闖蕩	chuǎngdàng	1. to leave home to make one's way in the world;2. to leave the life one knows to seek success
 田間	tiánjiān	1. field;2. farm;3. farming area;4. village
 左	zuǒ	1. left;2. the Left (politics);3. east;4. unorthodox;5. queer;6. wrong;7. differing;8. opposite;9. variant of 佐[zuo3]
 釘	dīng	1. nail;2. to follow closely;3. to keep at sb (to do sth);4. variant of 盯[ding1];5. to join things together by fixing them in place at one or more points;6. to nail;7. to pin;8. to staple;9. to sew on
