愛好	àihào	hobby, interest
愛好	àihào	love, like, be fond of, be keen on
愛護	àihù	cherish, treasure, take good care of
愛情	àiqíng	lovebetween man and woman
愛人	àirén	lover, sweetheart
愛惜	àixí	treasure
愛心	àixīn	mercy, benevolence, pity
哎呀	āiya	inj.: of wonder/admiration/shock
哎喲	āiyāo	inj.: of surprise/pain
安定	āndìng	stabilize
安慰	ānwèi	comfort, console
安心	ānxīn	feel at ease, be relieved, keep one's mind on sth.
按時	ànshí	on time/schedule
按照	ànzhào	according to, in the light of, on the basis of
暗中	ànzhōng	in secret, surreptitiously, in the dark
骯髒	āngzhāng	dirty
把握	bǎwò	assurance, certainty
把握	bǎwò	grasp firmly
罷工	bàgōng	go on strike
罷了	bàle	particle: elucidating a previous proposition so as to diminish its effect
擺脫	bǎituō	break away from, cast awayold ideas, etc., get rid of, to break out of
拜訪	bàifǎng	pay a visit, call on
拜年	bàinián	pay New Year's call, wish sb. Happy New Year
拜託	bàituō	request sb. to do sth.
班機	bānjī	airliner, regular air service, scheduled flight
搬運	bānyùn	move, transport
班長	bānzhǎng	class monitor, squad leader, workteam leader
辦公	bàngōng	handle official business, workusu. in an office
辦理	bànlǐ	handle handle, conduct, transact
半路	bànlù	halfway, midway
辦事	bànshì	handle affairs, work
半數	bànshù	half
扮演	bànyǎn	play part of
半夜	bànyè	midnight, inthe middle of the night, half a night
傍晚	bāngwǎn	dusk, nightfall
榜樣	bǎngyàng	example, model
棒子	bàngzi	stick, club, cudgel
包括	bāokuò	include, consist of, comprise, incorporate
包裹	bāoguǒ	bundle parcel
包含	bāohán	contain, embody, include
包裝	bāozhuāng	pack, dress up
包裝	bāozhuāng	packing, packaging, package
寶寶	bǎobǎo	precious
寶貝	bǎobèi	treasure
保持	bǎochí	maintain
保存	bǎocún	preserve
寶貴	bǎoguì	valuable, precious
保護	bǎohù	protect, safeguard
保留	bǎoliú	continue to have, retain, hold back, reserve
保守	bǎoshǒu	conservative
保衛	bǎowèi	defend, safeguard
保險	bǎoxiǎn	insurance
保養	bǎoyǎng	take good care of one's health, maintain, keep in good repair
保障	bǎozhàng	ensure, safeguard
保障	bǎozhàng	protection, safeguard, indemnification
報仇	bàochóu	revenge
報答	bàodá	repay requite
報導	bàodǎo	report
報到	bàodào	register
報告	bàogào	report, speech, studentterm paper
報告	bàogào	report, make known
報警	bàojǐng	reportan incidentto the police
暴力	bàolì	violence, force
報名	bàomíng	enter one's name, sign up
報社	bàoshè	newspaper office
抱怨	bàoyuàn	complain, grumble
爆炸	bàozhà	explode, blow up
暴躁	bàozào	petulant, irascible, explosive
悲劇	bēijù	tragedy
悲痛	bēitòng	grieve, sorrow, painfully sad
背包	bēibāo	knapsack, rucksack, field pack, shoulder bag, blanket roll
北部	běibù	northern part
北方	běifāng	north, northern part of country
被動	bèidòng	passive
背後	bèihòu	behind, in the rear, behind/at the back
背景	bèijǐng	background, backdrop
背面	bèimiàn	the reverse side, the wrong side, rear, the back
輩子	bèizi	all one's life, lifetime
奔跑	bēnpǎo	run
本來	běnlái	original
本領	běnlǐng	capacity ability capability, skill, ability
本人	běnrén	I, me, myself, oneself, in person
本土	běntǔ	one's native country, metropolitan territory
笨重	bènzhòng	awkward
彼此	bǐcǐ	each other, one another
比方	bǐfāng	for instance
比方	bǐfāng	analogy, instance, supposition, illustration by example
筆記	bǐjì	notes, short sketches
比較	bǐjiào	contrast, comparasion
比較	bǐjiào	compare, contrast
比例	bǐlì	proportion, scale
比如	bǐrú	for example
筆試	bǐshì	take a written test
畢竟	bìjìng	after all, when all is said and done
避免	bìmiǎn	avoid, refrain from, avert
必須	bìxū	necessary, required
必要	bìyào	necessary, indispensable
必要	bìyào	need
鞭炮	biānpào	firecrackers, string of small firecrackers
變動	biàndòng	change, alternation
變動	biàndòng	change, fluctuate
變更	biàngēng	change, modify
便利	biànlì	facilitate
便條	biàntiáo	[informal] note
標題	biāotí	title, heading, headline, caption
標誌	biāozhì	sign, mark, symbol
標準	biāozhǔn	standard
標準	biāozhǔn	standard, criterion
表達	biǎodá	express, convey ,voice
表弟	biǎodì	younger male cousin of different surname
表哥	biǎogē	older male cousin of different surname
表格	biǎogé	form, table
表妹	biǎomèi	younger female cousin of different surname
表面	biǎomiàn	surface, face, outside, appearance
表情	biǎoqíng	a facial expression, countenance
表示	biǎoshì	show, express, indicate
表揚	biǎoyáng	praise, commend
病毒	bìngdú	virus
病房	bìngfáng	hospital ward, sickroom
並且	bìngqiě	and, besides, moreover
菠菜	bōcài	spinach
波動	bōdòng	undulate, fluctuate
玻璃	bōlí	glass
伯伯	bóbo	father's elder brother, uncle
伯父	bófù	father's older brother, uncleaddress to male of father's generation
伯母	bómǔ	wife of father's elder brother, aunt
薄弱	bóruò	frail, weak
博士	bóshì	Ph.D. , court academician, master of any trade/craft
脖子	bózi	neck
不大	búdà	not very, not too
不當	búdàng	unsuitable, inappropriate
不到	búdào	be less than
不斷	búduàn	unceasing, continuous
不斷	búduàn	unceasingly, continuously
不顧	búgù	ignore
不過	búguò	only, merely
不過	búguò	no more than
不利	búlì	unfavorable, detrimental, unsuccessful
不論	búlùn	no matter how/who/what/etc.
不幸	búxìng	unfortunate
不再	búzài	no more/longer
補償	bǔcháng	compensate
補充	bǔchōng	replenish, supplement
補課	bǔkè	give students an special class or tutori, supplement a lesson, make up a missed lesson
補習	bùxí	take lessons after school/work
補助	bǔzhù	subsidization
補助	bǔzhù	subsidize
不安	bùān	be anxious, be uneasy, be restless
不成	bùchéng	cannot, should not, must not
部隊	bùduì	army, troops
不合	bùhé	conflict withopinioon, rules, etc.,
不僅	bùjǐn	not only
不良	bùliáng	bad, harmful
不滿	bùmǎn	resentful, dissatisfied
部門	bùmén	department, branch, classification
不平	bùpíng	dissatisfied, unfair, uneven
不然	bùrán	otherwise, if not, or else
不如	bùrú	it would be better to
不如	bùrú	be unequal/inferior to
不停	bùtíng	continuously
不許	bùxǔ	forbid, do not permit
不許	bùxǔ	disallow
不宜	bùyí	be unsuitable
部長	bùzhǎng	minister, head of a section
不止	bùzhǐ	not be limitedto, endless
不只	bùzhǐ	not only, not merely
不准	bùzhǔn	disallow
不足	bùzú	not be enough, not be worthdoing sth., cannot, should not
財產	cáichǎn	property
財富	cáifù	wealth, fortune, riches
材料	cáiliào	material, data, stuff, ingredients
才能	cáinéng	ability, talent
裁判	cáipàn	judge, referee, umpire
採購	cǎigòu	purchase
彩色	cǎisè	colorful
採用	cǎiyòng	select for use, employ, adopt
參考	cānkǎo	consult, refer to
倉庫	cāngkù	warehouse, godown, granary, treasury vault
慚愧	cánkuì	ashamed
操場	cāochǎng	playground, sportsground ,drill ground
操心	cāoxīn	trouble about, take pains, worry, care, take trouble, wrack one's brains, worry about
操作	cāozuò	operate, manipulate
測量	cèliáng	measure, survey
策略	cèlüè	tactics
測試	cèshì	survey, measure and test
測驗	cèyàn	test
測驗	cèyàn	test, quiz
曾經	céngjīng	once, ever
差別	chābié	difference
差錯	chācuò	mistake, error, mishap
插花	chāhuā	decorate with flowers, insert/arrange flowers
差距	chājù	spatial difference
插圖	chātú	book illustrations/pictures
差異	chāyì	difference, divergence, discrepancy, diversity
茶會	cháhuì	tea party
茶葉	cháyè	tea leaves
產量	chǎnliàng	output, yield
產生	chǎnshēng	come into being, produce, engender, emerge
產業	chǎnyè	estate, property, industry
長處	chángchù	forte, strong/good points
長度	chángdù	length
長久	chángjiǔ	for a long time, permanently
長期	chángqí	long period of time, long-term
常識	chángshì	general knowledge, common sense
長途	chángtú	long distance
場地	chǎngdì	space, place, site
場合	chǎnghé	occasion, situation
廠商	chǎngshāng	firm, business
場所	chǎngsuǒ	place, arena
超出	chāochū	exceed, go beyond, overstep
超過	chāoguò	outstrip, surpass, exceed
超級	chāojí	super
鈔票	chāopiào	bank note, paper money, bill
超人	chāorén	superman
抄寫	chāoxiě	copy, transcribe
超越	chāoyuè	exceed
超重	chāozhòng	be overweight, overweight
潮流	cháoliú	trend
吵架	chǎojià	quarrel, have a row/spat
吵鬧	chǎonào	wrangle, kick up a row
車禍	chēhuò	traffic accident
車票	chēpiào	ticketfor train/bus
徹底	chèdǐ	complete, thorough
陳列	chénliè	display, exhibit
成本	chéngběn	cost
成果	chéngguǒ	achievement, gain, positive result
成交	chéngjiāo	close a deal
成就	chéngjiù	achievement, accomplishment, success
乘客	chéngkè	passenger
誠懇	chéngkěn	sincere
成立	chénglì	found, establish
承認	chéngrèn	admit, acknowledge, recognize, give diplomatic recognition
成熟	chéngshú	ripe, mature
成天	chéngtiān	all day long, all the time
成為	chéngwéi	become, turn into
呈現	chéngxiàn	present, appear, emerge
程序	chéngxù	procedure, order, course, sequence, program
誠意	chéngyì	good faith, sincerity
成語	chéngyǔ	set phrase, idiom
成長	chéngzhǎng	grow up, mature
吃虧	chīkuī	suffer loss, come to grief
遲早	chízǎo	sooner or later
尺寸	chǐcùn	dimension, measurement
翅膀	chìbǎng	wing
充滿	chōngmǎn	be brimming/permeated with
充實	chōngshí	substantiate, enrich, replenish
充足	chōngzú	adequate; sufficient; abundant; ample
崇拜	chóngbài	worship, adore
崇高	chónggāo	lofty, sublime
重新	chóngxīn	again, anew, afresh
抽屜	chōutì	drawer
出版	chūbǎn	come off the press, publish, come out
初步	chūbù	initial, preliminary, tentative
初步	chūbù	initially, preliminarily, tentatively
出差	chūchāi	be away on official business or on a bus, be on a business trip, be away on official business
出產	chūchǎn	produce, manufacture
初級	chūjí	elementary, primary
出境	chūjìng	leave country, leave the country
出口	chūkǒu	exit
出門	chūmén	be away from home, go on journey, go out
出色	chūsè	outstanding, remarkable, splendid
出身	chūshēn	class origin, family background;one's previous experience/occupation
出生	chūshēng	be born
出事	chūshì	meet with mishap, have accident, meet with a mishap, have an accident
出售	chūshòu	offer for sale, sell
出席	chūxí	attend, be present
出院	chūyuàn	leave hospital
出租	chūzū	hire, let, rent
儲存	chúcún	lay in/up, store, stockpile
除非	chúfēi	only if/when, unless
廚師	chúshī	cook, chef
除夕	chúxì	New Year's Eve
儲蓄	chúxù	save, deposit
處罰	chǔfá	punish, penalize
處理	chǔlǐ	handle, deal with, dispose of, process
處處	chùchù	everywhere, in all respects
傳播	chuánbò	disseminate, propagate, spread
傳達	chuándá	pass on, transmit, communicate
傳單	chuándān	leaflet, handbill
床單	chuángdān	bedclothes, bedcover, counterpane, bedsheet, bedspread, bed linen
傳染	chuánrǎn	infect, be contagious
傳說	chuánshuō	it is said, they say
傳說	chuánshuō	legend
傳送	chuánsòng	transmit, deliver
傳統	chuántǒng	tradition
傳統	chuántǒng	traditional
傳真	chuánzhēn	fax
傳真	chuánzhēn	fax, facsimile
窗口	chuāngkǒu	window, wicket, ticket window
創造	chuàngzào	create, produce, bring about
創作	chuàngzuò	creative work, creation
春季	chūnjì	spring, springtime
春假	chūnjià	spring vacation/holidays
磁帶	cídài	magnetic tape
詞典	cídiǎn	dictionary
此外	cǐwài	besides, in addition, moreover
刺激	cìjī	provoking, exciting
刺激	cìjī	stimulate, provoke, irritate, upset
刺激	cìjī	stimulation
次數	cìshù	number of times, frequency
從不	cóngbù	never
從此	cóngcǐ	henceforth, thereupon
從沒	cóngméi	not yet
從事	cóngshì	be engaged in, deal with, go in for
從小	cóngxiǎo	from childhood, as a child
粗心	cūxīn	careless
存款	cúnkuǎn	deposit, bank saving
存在	cúnzài	exist, be
促進	cùjìn	promote, accelerate
錯過	cuòguò	miss, let slip
錯字	cuòzì	wrongly written characters, misprint
挫折	cuòzhé	frustration, setback
答案	dá'àn	answer, solution, key
達成	dáchéng	reachan agreement
達到	dádào	achieve, reach, attain
打扮	dǎbàn	dress/make up, deck out, pose as
打包	dǎbāo	pack, bale, unpack, package, box, load down
打斷	dǎduàn	break
打工	dǎgōng	work part-time while studying in college/etc.
打架	dǎjià	fight, scuffle, come to blows
打擾	dǎrǎo	disturb, trouble
打算	dǎsuàn	plan
打聽	dǎtīng	inquire/ask about
打仗	dǎzhàng	wage war, fight battle
打折	dǎzhé	tuck, sell at a discount
打針	dǎzhēn	give an injection, have an injection
打字	dǎzì	do typing work, typewritten, typewrite, type
大半	dàbàn	more than half
大大	dàdà	great, greatly
大膽	dàdǎn	audacious, bold, daring
大地	dàdì	earth, mother earth
大都	dàdōu	for the most part, mostly
大方	dàfāng	1generous; 2elegant and composed, natural and poised
大哥	dàgē	eldest brother, gang leader
大會	dàhuì	rally, plenary meeting, conference
大街	dàjiē	main street
大力	dàlì	with great exertion
大量	dàliàng	large quantity, a great deal, considerable, mass
大門	dàmén	main entrance/door/gate
大腦	dànǎo	cerebrum
大嫂	dàsǎo	wife of eldest brother, polite name for woman about one's own age
大腿	dàtuǐ	thigh
大小	dàxiǎo	size
大型	dàxíng	large-sizemachines/factories/etc.
大意	dàyì	careless
大有	dàyǒu	have
大約	dàyuē	about, around, probably, likely
大眾	dàzhòng	the people/masses
大致	dàzhì	roughly
代表	dàibiǎo	represent, indicate
帶動	dàidòng	drive, spur on, bring along
大夫	dàifū	doctor, physician
代溝	dàigōu	generation gap
代價	dàijià	price, costof doing sth.
貸款	dàikuǎn	loan
貸款	dàikuǎn	grant a loan, credit
帶來	dàilái	bring, bring about
代理	dàilǐ	act as agent/proxy
帶領	dàilǐng	leadarmy/party/etc., guide
帶路	dàilù	show the way, lead way, lead the way, show way, act as a guide
代替	dàitì	take the place of, substitute for
待遇	dàiyù	treatmentsalary/etc.
帶子	dàizi	belt
擔保	dānbǎo	pledge, guaranty, assurance, security, sponsion, surety, wager, cover, warranty, guarantee
單純	dānchún	simple, pure, plain, artless
單調	dāndiào	monotonous, dull, drab, boring
擔任	dānrèn	assume office of, take charge of
單身	dānshēn	unmarried, single
單位	dānwèi	unit of measurement
耽誤	dānwù	delay, hold up
單子	dānzi	list, bill, form, bed sheet
膽量	dǎnliàng	courage, guts
誕生	dànshēng	be born, come into being, emerge
當場	dāngchǎng	on the spot, then and there
當初	dāngchū	at that time
當地	dāngdì	locality, the placenamed/mentioned/etc.
當面	dāngmiàn	face to face, in one's presence
當年	dāngnián	that year, those years, bygone years, prime of life
當時	dāngshí	at that time, then
當天	dāngtiān	same day, that very day
當選	dāngxuǎn	get elected
當中	dāngzhōng	[aspect]in the course of
當做	dāngzuò	consider/treat as
當作	dāngzuò	consider/treat as
檔案	dǎngàn	file, record, dossier, archives
導演	dǎoyǎn	direct film/play/etc.
導演	dǎoyǎn	director
到達	dàodá	reach, arrive
道德	dàodé	morality, ethics, morals
到底	dàodǐ	to the end
道教	dàojiào	Daoismas a religion
道路	dàolù	road, way, path
道歉	dàoqiàn	apologize
倒是	dàoshì	actually, contrariwise
得分	défēn	score
得獎	déjiǎng	win a prize
得了	déle	well! well! ; it's enough! ; have done with it!
得意	déyì	be proud of, be exalted, be complacent
得罪	dézuì	offend, displease
燈光	dēngguāng	lamplight
登記	dēngjì	register, check in
登山	dēngshān	mountaineering
等待	děngdài	wait for, await
等到	děngdào	until
等等	děngděng	and so on, etc
等級	děngjí	grade, rank, order and degree, social status
等於	děngyú	be equal/tantamount to
凳子	dèngzi	stool, bench
的確	díquè	certainly, surely
敵人	dírén	enemy
抵達	dǐdá	reach, arrive at
抵抗	dǐkàng	resist, stand up to
地板	dìbǎn	floorboard, floor
地帶	dìdài	zone, belt, district, region
地點	dìdiǎn	place, site, locale
地理	dìlǐ	geography, geographical features of a place
地面	dìmiàn	earth'ssurface, ground, floor, region
地球	dìqiú	the earth/globe
地攤	dìtān	stall with goods spread out on ground for sale
地毯	dìtǎn	carpet, rug
地鐵	dìtiě	subway, undergroundrailway
地位	dìwèi	position, status
地下	dìxià	underground, secret activity
地形	dìxíng	topography, terrain
地震	dìzhèn	earthquake
典禮	diǎnlǐ	ceremony, celebration
點燃	diǎnrán	light, kindle, ignite
點頭	diǎntóu	nod one's head
典型	diǎnxíng	typical, representative
電報	diànbào	telegram, cable
電池	diànchí	electriccell, battery
電動	diàndòng	electric
電扇	diànshàn	electric fan
電台	diàntái	broadcasting station
電梯	diàntī	elevator
電線	diànxiàn	electricwire
店員	diànyuán	shop assistant, salesclerk
電子	diànzǐ	electron
雕刻	diāokè	carve, engrave
雕刻	diāokè	statue
調查	diàochá	investigate, look into, survey
跌倒	diédǎo	fall, tumble
訂婚	dìnghūn	be betrothed, be engaged, troth, betroth, plight
定期	dìngqí	periodical, regular
定期	dìngqí	fixedof time, periodically, regularly
訂位	dìngwèi	engage, book, reserve
丟臉	diūliǎn	lose face, reflect, be disgraced, humiliate
丟人	diūrén	lose face, be disgraced
東北	dōngběi	the northeast
東部	dōngbù	east
東方	dōngfāng	east
冬季	dōngjì	winter
東南	dōngnán	southeast
懂得	dǒngde	understand, know
懂事	dǒngshì	sensible
動詞	dòngcí	verb
動人	dòngrén	moving, touching
動身	dòngshēn	set out on a journey
動手	dòngshǒu	strike, hit
動作	dòngzuò	demeanor, motion, behavior, performance, operation, looseness, agency, gesticulation, movement, comportment, business, action
豆腐	dòufǔ	beancurd
豆漿	dòujiāng	soybean milk
鬥爭	dòuzhēng	battle, fight
都市	dūshì	city
獨立	dúlì	stand alone
毒品	dúpǐn	narcotics, drugs
獨特	dútè	unique, distinctive
獨自	dúzì	alone, by oneself
讀者	dúzhě	reader
鍛鍊	duànliàn	engage in physical exercise, temper, steel, toughen
對岸	duìàn	other side of river
對策	duìcè	way to deal with a situation
對待	duìdài	treat, approach, handle
對付	duìfù	deal/cope with, counter, tackle, make do
對話	duìhuà	dialogue
對抗	duìkàng	resist, oppose
對立	duìlì	oppose, set sth. against, be antagonist to
對象	duìxiàng	target, object
對於	duìyú	in regardto, toward, at, for
隊員	duìyuán	team member
多多	duōduō	
多少	duōshǎo	somewhat, to some extent, more or less
多數	duōshù	majority
多謝	duōxiè	thank you very much
惡劣	èliè	vile, nasty
而且	érqiě	furthermore, besides ,moreover
而已	éryǐ	particle : imparting finalitythat's all
發表	fābiǎo	publish, issue
發財	fācái	get rich, make a pile
發出	fāchū	issue, send/give out
發達	fādá	developed, flourishing
發動	fādòng	mobilize, arouse
發抖	fādǒu	shiver, shake, quiver, tremble
發揮	fāhuī	bring into play, give free rein to, developidea/etc., elaborate
發覺	fājué	find, detect, discover
發明	fāmíng	invention
發明	fāmíng	invent, expound
發起	fāqǐ	initiate, sponsor, start, launch
發射	fāshè	launch, project, discharge, shoot, transmit, emit
發行	fāxíng	issue, publish, distribute, put on sale
發言	fāyán	speak, make statement/speech
發揚	fāyáng	develop, carry on, make most of
發音	fāyīn	pronounce
發展	fāzhǎn	develop, expand, grow
法子	fázi	way, method
法律	fǎlǜ	law, statute
髮型	fǎxíng	haircut
法院	fǎyuàn	court of justice, lawcourt
翻譯	fānyì	translate, interpret
煩惱	fánnǎo	vexation
煩惱	fánnǎo	vexed, worried
繁榮	fánróng	flourishing, prosperous, booming
繁殖	fánzhí	breed, reproduce, propagate
反對	fǎnduì	oppose, be against, combat, dispute
反而	fǎnér	on the contrary, instead
反覆	fǎnfù	repeatedly, over and overagain, again and again
返回	fǎnhuí	return, come/go back
反抗	fǎnkàng	revolt, resist
反面	fǎnmiàn	reverse/wrong side, back, opposite, negative side
反問	fǎnwèn	aska questionin reply
反映	fǎnyìng	reflect, mirror
反應	fǎnyìng	react, respond
反應	fǎnyìng	reaction, response, repercussion
反正	fǎnzhèng	anyway, anyhow, in any case
犯法	fànfǎ	violate law, break law, offend, violate the law, criminal, transgress, break the law
犯人	fànrén	criminal, prisoner, convict
範圍	fànwéi	scope, range, extent, parameter
犯罪	fànzuì	commit crime/offense
方案	fāngàn	scheme, plan, program
房客	fángkè	tenant
防守	fángshǒu	defend, guard
房屋	fángwū	houses, buildings
防止	fángzhǐ	prevent, guard against, avoid
放大	fàngdà	enlarge, magnify, amplify
放棄	fàngqì	abandon, give up, renounce
放手	fàngshǒu	let_go
放學	fàngxué	finish classesfor the day
非法	fēifǎ	illegal, unlawful, illicit
肥胖	féipàng	fat, corpulent
肥皂	féizào	soap
廢話	fèihuà	superfluous words, nonsense, rubbish
廢氣	fèiqì	waste gas/steam, fume
廢水	fèishuǐ	waste water, effluent
廢物	fèiwù	a good-for-nothing
分別	fēnbié	difference
分別	fēnbié	distinguish, differentiate
分別	fēnbié	leave each other
分別	fēnbié	separately, respectively
紛紛	fēnfēn	in droves, numerous and in great confusion
吩咐	fēnfù	tell, bid, order, instruct, enjoin, say
分工	fēngōng	divide the work, to work together on a project but doing different things
分開	fēnkāi	separate, part, break up
分明	fēnmíng	clear, evident
分配	fēnpèi	distribute, allot, assign
分散	fēnsàn	disperse, scatter, decentralize
分手	fēnshǒu	part company,  say good-bye, break up
分數	fēnshù	a mark, a grade, a score
分析	fēnxī	analysis
分析	fēnxī	analyze
粉筆	fěnbǐ	chalk
奮鬥	fèndòu	struggle, fight, strive
憤怒	fènnù	indignant, angry
風格	fēnggé	style
封建	fēngjiàn	feudal, feudalistic
瘋狂	fēngkuáng	insane, frenzied, unbridled
蜂蜜	fēngmì	honey
風氣	fēngqì	general mood, atmosphere, common practice
風趣	fēngqù	humourous
風俗	fēngsú	custom
風險	fēngxiǎn	risk, hazard
瘋子	fēngzi	lunatic, madman
諷刺	fèngcì	satirize, mock
佛教	fójiào	Buddhism
否定	fǒudìng	negate, deny
否認	fǒurèn	deny, repudiate
否則	fǒuzé	otherwise, if not, or else
夫婦	fūfù	husband and wife
夫妻	fūqī	husband and wife
夫人	fūrén	Lady, Madame, Mrs.
符號	fúhào	symbol, mark ,insignia
符合	fúhé	accord/tally with, conform to
福利	fúlì	material benefits, well-being, welfare
服裝	fúzhuāng	dress, clothing, costume
腐敗	fǔbài	corrupt
輔導	fǔdǎo	coach, tutor
付出	fùchū	pay, expend
負擔	fùdān	bear, shoulder
負擔	fùdān	burden, load, encumbrance
附加	fùjiā	add, attach
父母	fùmǔ	father and mother, parents
婦女	fùnǚ	women
富裕	fùyù	plentiful, abundant, rich
複雜	fùzá	complicated, complex
複製	fùzhì	duplicate, reproduce
改革	gǎigé	reform
改進	gǎijìn	improve
改善	gǎishàn	improve, perfect
改天	gǎitiān	on some other day
改造	gǎizào	transform, reform, remold, remake
改正	gǎizhèng	correct, amend
概念	gàiniàn	concept, conception, notion, idea
蓋子	gàizi	lid, cover, cap, top, shellof tortoise/etc.
乾杯	gānbēi	pledge, wassail, toast
乾脆	gāncuì	direct, forthright
感到	gǎndào	feel, sense
感動	gǎndòng	move, touch
感激	gǎnjī	feel grateful/indebted
趕緊	gǎnjǐn	hurriedly, losing no time
感情	gǎnqíng	emotion, feeling, sentiment
感染	gǎnrǎn	infect, influence, affect
趕上	gǎnshàng	overtake, run intosituation, be in time for
感受	gǎnshòu	be affected by, experience, feel
感想	gǎnxiǎng	impression, reflections, thoughts
幹部	gànbù	cadre, staff
幹嘛	gànmá	do what
幹嘛	gànmá	why on earth, whatever for
鋼筆	gāngbǐ	fountain pen
剛好	gānghǎo	exact, just right
鋼琴	gāngqín	piano
港幣	gǎngbì	Hong_Kong_dollar
港口	gǎngkǒu	port, harbor
高潮	gāocháo	upsurge, climax
高大	gāodà	tall and big, great, massive
高度	gāodù	highly, greatly
高度	gāodù	altitude, height, high degree
高峰	gāofēng	peak, height
高貴	gāoguì	noble, high
高級	gāojí	high-level, high-class, quality
高明	gāomíng	brilliant, wise
高速	gāosù	high-speed
高手	gāoshǒu	expert, ace
高原	gāoyuán	plateau, tableland
高中	gāozhōng	senior high school
告辭	gàocí	take leave
歌劇	gējù	opera
歌曲	gēqǔ	song
歌星	gēxīng	singing star
隔壁	gébì	next door
革命	gémìng	revoloution
革命	gémìng	revolt
個別	gèbié	individual, specific
個兒	gèer	stature
個性	gèxìng	individual character, personality, specific property, particularity
個子	gèzi	height, stature, build
根本	gēnběn	at all, utterly
根本	gēnběn	essence, foundation
根據	gēnjù	basis, grounds, foundation
根據	gēnjù	on the basis of, according to
更加	gèngjiā	evenmore
工廠	gōngchǎng	factory, mill, plant, works
工程	gōngchéng	engineering project
工夫	gōngfu	time
功夫	gōngfu	time, kung fu
工會	gōnghuì	trade/labor union
工具	gōngjù	tool, instrument, implement
公開	gōngkāi	make public, make known to public
公立	gōnglì	public, established and maintained by the government
功能	gōngnéng	function, competence
公平	gōngpíng	fair, just, impartial
工錢	gōngqián	pay
公式	gōngshì	formula, form
工業	gōngyè	industry
供應	gōngyìng	supply
公用	gōngyòng	be for public use
公元	gōngyuán	Christian era
工資	gōngzī	wages, pay
共同	gòngtóng	together, jointly
共同	gòngtóng	common, joint
貢獻	gòngxiàn	contribution
貢獻	gòngxiàn	contribute, dedicate, devote
溝通	gōutōng	communicate, link up
構成	gòuchéng	constitute, form, compose, make up
購買	gòumǎi	purchase, buy
構造	gòuzào	structure, construction
孤單	gūdān	alone, friendless
姑姑	gūgū	father's sister
估計	gūjì	estimate, appraise, reckon
姑娘	gūniáng	girl, daughter
古代	gǔdài	antiquity
古典	gǔdiǎn	classical
古蹟	gǔjī	antiquity, high spot, national monument
古老	gǔlǎo	ancient, old
鼓勵	gǔlì	encouragement
鼓勵	gǔlì	encourage, urge
骨頭	gǔtou	bone, strong character, person of a certain character
鼓舞	gǔwǔ	inspire, hearten, dance for joy, rejoice
鼓掌	gǔzhǎng	clap one's hands, applaud
固定	gùdìng	flat, stabile, regular
顧客	gùkè	customer, shopper, c lient
顧問	gùwèn	adviser, consultant
故鄉	gùxiāng	native place, hometown, birthplace
故意	gùyì	intentional, willful
瓜子	guāzi	melon seed, melon seeds
掛號	guàhào	register, registered
觀察	guānchá	observe, survey, inspect
觀點	guāndiǎn	point of view, standpoint
官方	guānfāng	government, official
觀光	guānguāng	go sightseeing, visit, tour
關鍵	guānjiàn	key, crux
觀念	guānniàn	sense, idea, conception
關上	guānshàng	shut, steek, close
關於	guānyú	about, with regard to, concerning
官員	guānyuán	official
觀眾	guānzhòng	spectator, audience
管道	guǎndào	pipeline, conduit, piping
管理	guǎnlǐ	manage, supervise, take care of
管制	guǎnzhì	control, put under surveillance
冠軍	guànjūn	champion
慣例	guànlì	usual practice
罐頭	guàntóu	tin, can, canned goods
罐子	guànzi	jug, jar, can
光亮	guāngliàng	bright
光臨	guānglín	be present
光明	guāngmíng	bright, promising, openhearted, guileless
光榮	guāngróng	honor, glory, c redit
光是	guāngshì	
光線	guāngxiàn	light, ray
廣場	guǎngchǎng	public square
廣大	guǎngdà	vast, wide, large-scale, wide-spread, numerous
廣泛	guǎngfàn	extensive, wide-ranging
廣告	guǎnggào	advertise
廣告	guǎnggào	advertisement
廣闊	guǎngkuò	vast, broad
逛街	guàngjiē	window-shop
規定	guīdìng	provide, formulate, fix, set
規定	guīdìng	rules, disciplines, regulations
規矩	guījǔ	rule, custom
規律	guīlǜ	law, regular pattern
規模	guīmó	scale, scope
規則	guīzé	rule, regulation
櫃子	guìzi	cupboard, cabinet
貴族	guìzú	noble, aristocrat
國會	guóhuì	parliament, congress
國籍	guójí	nationality
國際	guójì	international
國立	guólì	state/national maintained/run
國內	guónèi	interiorof country, internal, domestic
國旗	guóqí	national flag
國外	guówài	overseas
國王	guówáng	king
國語	guóyǔ	national language written and spoken, textbook for primary/middle school students
國小	guóxiǎo	primary school
國中	guózhōng	middle school, junior high school
果然	guǒrán	really, as expected, sure enough
過程	guòchéng	course, process
過渡	guòdù	ferry stream
過度	guòdù	excessive
過節	guòjié	celebrate a festival
過濾	guòlǜ	filtrate
過期	guòqí	overdue, be overdue, exceed the time limit, stale
過世	guòshì	die, pass away
還好	háihǎo	fortunately
還要	háiyào	even/still more
還有	háiyǒu	furthermore, in addition
海報	hǎibào	a playbill, a placard, a poster
海關	hǎiguān	customhouse, customs
海軍	hǎijūn	navy
海灘	hǎitān	beach
海外	hǎiwài	overseas, abroad
海峽	hǎixiá	strait, channel
海鮮	hǎixiān	seafood
害處	hàichù	harm
寒冷	hánlěng	cold, frigid
含量	hánliàng	content
航空	hángkōng	aviation
行業	hángyè	trade, profession, industry
毫無	háowú	completely lack
好多	hǎoduō	many, much
好在	hǎozài	fortunately, luckily
好客	hàokè	hospitable
好奇	hàoqí	curious, full of curiosity
號召	hàozhào	call, appealfor supporters
何必	hébì	why must...?, there is no need
合唱	héchàng	sing in a chorus
合成	héchéng	compose, compound, synthesize
合法	héfǎ	lawful, legitimate, rightful
合格	hégé	qualify, reach standard, pass
和好	héhǎo	become reconciled
合乎	héhū	conform with/to, accord/tally with
何況	hékuàng	much less, let alone, all the more
合理	hélǐ	rational, reasonable, equitable
河流	héliú	river
和平	hépíng	mild, peaceful
和氣	héqì	friendly
合算	hésuàn	reckon up, total
合適	héshì	suitable, appropriate, becoming, right
黑暗	hēiàn	dark
黑夜	hēiyè	dark night
痕跡	hénjī	mark, trace, vestige
喉嚨	hóulóng	throat
猴子	hóuzi	monkey, clever/glib/sharp-tongued person
後代	hòudài	later periods/ages/generations, descendants, posterity, progeny
後方	hòufāng	rear
後果	hòuguǒ	consequence, aftermath
後悔	hòuhuǐ	regret, repent
後年	hòunián	year after next
後頭	hòutóu	rear, behind
後退	hòutuì	draw back
後院	hòuyuàn	backyard
紅豆	hóngdòu	red bean, azuki bean, love pea
忽略	hūlüè	neglect, overlook ,lose sight of
忽視	hūshì	ignore, overlook, neglect
呼吸	hūxī	breathe, respire
糊塗	hútú	muddled, confused, thoughtless, slipshod
鬍子	húzi	beard, moustache, whiskers
戶外	hùwài	outdoor
互助	hùzhù	help each other
花草	huācǎo	flowers and plants
花費	huāfèi	expenditure, expenses
花費	huāfèi	spend, expend
花盆	huāpén	flowerpot, pot, planter
花瓶	huāpíng	flower vase, secretary kept for her good looks rather than ability
花色	huāsè	design and color, variety of designs/sizes/colors/etc.
花生	huāshēng	peanut
華僑	huáqiáo	overseas Chinese
話題	huàtí	subject of a talk, topic of conversation, topic
化學	huàxué	chemistry
化裝	huàzhuāng	disguise oneself
化妝	huàzhuāng	apply make-up
懷孕	huáiyùn	be pregnant
壞處	huàichù	harm, disadvantage, defect
壞蛋	huàidàn	scoundrel, bastard
歡呼	huānhū	hail, acclaim
歡樂	huānlè	happy, joyous, gay
歡喜	huānxǐ	like, be fond of
環保	huánbǎo	environmental protection
緩和	huǎnhé	relax, ease up, mitigate, appease
緩慢	huǎnmàn	slow
幻想	huànxiǎng	imagination, fantasy, daydream
幻想	huànxiǎng	imagine, daydream, fantasticate, fancify, dream, fancy, fantasize
皇帝	huángdì	emperor
黃豆	huángdòu	soya bean, soybean
黃昏	huánghūn	dusk
恢復	huīfù	resume, renew, recover, regain, restore, reinstate, rehabilitate
灰色	huīsè	gray ,ashy, pessimistic, gloomy
灰心	huīxīn	lose heart, be discouraged
回電	huídiàn	wire back
回教	huíjiào	Islam
回收	huíshōu	recycle
回頭	huítóu	turn one's head, turn round
回想	huíxiǎng	think back, recollect, recall
回信	huíxìn	replyletter
回憶	huíyì	recollect, recall
會場	huìchǎng	meeting place, conference/assembly hall
匯款	huìkuǎn	make a remittence, remit
會員	huìyuán	member
昏倒	hūndǎo	faint
婚禮	hūnlǐ	wedding ceremony
昏迷	hūnmí	remain unconscious
婚姻	hūnyīn	marriage, matrimony
混合	hùnhé	mix, blend, mingle
混亂	hùnluàn	confused, chaotic
活該	huógāi	serve sb. right, deservedly be, be destined to, ought, should
活力	huólì	vigor, vitality, energy
活潑	huópō	lively, vivacious, vivid
活躍	huóyuè	enliven, animate, invigorate
火柴	huǒchái	match
火腿	huǒtuǐ	ham
火災	huǒzāi	a fireaccident, a conflagration, a blaze
獲得	huòdé	gain, acquire, win, a chieve
貨物	huòwù	goods, commodity, merchandise
或許	huòxǔ	perhaps, maybe
或者	huòzhě	or, either or
基本	jīběn	fundamental, essential, main
基本	jīběn	basic, elementary
基礎	jīchǔ	base, foundation
激動	jīdòng	stirred, agitated
機構	jīgòu	organization, internal structure of an organization
機關	jīguān	1office, organ; 2mechanism, stratagem, scheme, intrigue
幾乎	jīhū	almost, nearly
積極	jījí	positive, active, energetic, vigorous
基金	jījīn	fund, endowment
激烈	jīliè	intense, sharp, fierce, acute
機票	jīpiào	plane ticket
肌肉	jīròu	muscle
機械	jīxiè	machine, machinery, mechanism
疾病	jíbìng	disease, illness
及格	jígé	pass ,nail, make it
集合	jíhé	gather, assemble, muster
即將	jíjiāng	about to, on the point of, soon
急忙	jímáng	in haste, hurriedly
寂寞	jímò	be lonely
極其	jíqí	extremely, exceedingly
及時	jíshí	timely, in time, promptly
即使	jíshǐ	even, even if/though
集郵	jíyóu	collect stamps
集中	jízhōng	focus, concentrate
集中	jízhōng	centralize, put together
計較	jìjiào	haggle over, dispute, discuss in minute detail, mind, care
記錄	jìlù	record, note
記錄	jìlù	record
紀念	jìniàn	commemorate, mark
紀念	jìniàn	commemoration, souvenir
技巧	jìqiǎo	technique, skill, craftsmanship, dexterity
既然	jìrán	since, as, now that
計算	jìsuàn	count, calculate, compute
技術	jìshù	technique, art
記性	jìxìng	memory capability
記憶	jìyì	memory
記憶	jìyì	remember, recall
記載	jìzǎi	put down in writing, record
記者	jìzhě	reporter, correspondent
記住	jìzhù	remember, learn by heart, bear in mind
加班	jiābān	work overtime, work extra shift
加工	jiāgōng	process
加強	jiāqiáng	strengthen, augment, reinforce
加入	jiārù	add, mix, put in
加速	jiāsù	speed up, accelerate, haste
加上	jiāshàng	add into
家事	jiāshì	housework, family matters
家鄉	jiāxiāng	hometown, native place
加以	jiāyǐ	handle, treatused before polysyllabic verbs or verbal nouns
加油	jiāyóu	refuel
家長	jiāzhǎng	head of household, parent of schoolchildren
假如	jiǎrú	if, supposing, in case
假裝	jiǎzhuāng	pretend, feign, simulate
價格	jiàgé	price
價錢	jiàqián	price
假日	jiàrì	holiday, day off
駕駛	jiàshǐ	driver, pilot
駕駛	jiàshǐ	drivevehicle, pilotship/plane
價值	jiàzhí	be worth
價值	jiàzhí	value, worth
肩膀	jiānbǎng	shoulder
堅持	jiānchí	persist in, insist on
堅定	jiāndìng	firm, staunch, steadfast
堅決	jiānjué	firm, determined
堅強	jiānqiáng	staunch, steadfast
尖銳	jiānruì	sharp-pointed
監獄	jiānyù	prison, jail
剪刀	jiǎndāo	scissors, shears
減輕	jiǎnqīng	lighten, ease, mitigate
減少	jiǎnshǎo	reduce, decrease
檢驗	jiǎnyàn	test, examine, inspect
簡直	jiǎnzhí	simply, really
漸漸	jiànjiàn	gradually, by degrees, little by little
間接	jiànjiē	indirect, at indirect, roundabout
建立	jiànlì	establish, set up, found
鍵盤	jiànpán	keyboard
健全	jiànquán	sound, perfect
建議	jiànyì	proposal, suggestion
建議	jiànyì	propose, suggest, recommend
建築	jiànzhú	build, construct, erect
建築	jiànzhú	building, structure, edifice, architecture
將要	jiāngyào	going to, will, shall
講價	jiǎngjià	bargain
講究	jiǎngjiù	tasteful, exquisite
獎金	jiǎngjīn	money award, bonus, premium
獎品	jiǎngpǐn	prize, award, trophy
降低	jiàngdī	reduce, cut down, drop, lower
降價	jiàngjià	lower prices
驕傲	jiāoào	be proud, take pride in
交代	jiāodài	explain, make clear, brief, tell, account for, justify oneself, confess
交換	jiāohuàn	exchange, swap
交際	jiāojì	assort, converse, social intercourse, intercommunicate, gam, socialize
交流	jiāoliú	exchange, interflow, interchange
交通	jiāotōng	traffic, communications, transportation
郊外	jiāowài	countryside around a city, outskirts
交往	jiāowǎng	associate, contact
交易	jiāoyì	deal, trade
交易	jiāoyì	deal, trade, transaction
交友	jiāoyǒu	make friends
腳步	jiǎobù	step, pace
角度	jiǎodù	angle
角落	jiǎoluò	corner, nook
教材	jiàocái	teaching material
教導	jiàodǎo	instruct, give guidance
教法	jiàofǎ	teaching methods, pedagogy
叫喊	jiàohǎn	shout, howl, scream
教會	jiàohuì	Christianchurch
教練	jiàoliàn	coach, instructor
教師	jiàoshī	teacher, instructor
教授	jiàoshòu	professor
教授	jiàoshòu	instruct, teach
教堂	jiàotáng	church, cathedral
教學	jiàoxué	teach and study
教訓	jiàoxùn	chide, lecture sb.
教訓	jiàoxùn	lesson, moral
接觸	jiēchù	come into contact with, get in touch with, engage, contact
接待	jiēdài	receiveguests, servecustomers
接到	jiēdào	receive
街道	jiēdào	street, residential district, neighborhood
階段	jiēduàn	stage, phase, level
接見	jiējiàn	receive sb., grant interview to
接近	jiējìn	intimate, close
接近	jiējìn	approach, near, be close to
街頭	jiētóu	streetcorner
結構	jiégòu	structure, composition, construction, texture
結果	jiéguǒ	result, outcome, consequence
結果	jiéguǒ	to bear fruit
結合	jiéhé	combine, unite, I ntegrate, link, be joined in wedlock
結局	jiéjú	final result, outcome, ending
結論	jiélùn	conclusionof a syllogism, conclusion
結算	jiésuàn	close an account, to reckon sth. up
節省	jiéshěng	save, thriftiness, stint, penny-pinching
節約	jiéyuē	economize, save
結帳	jiézhàng	settle accounts, square accounts, balance the books, square_up
截止	jiézhǐ	end, close, cut off
解除	jiěchú	remove, relieve, get rid of
解答	jiědá	answer, explain
界線	jièxiàn	boundary/dividing line, limits, bounds
戒指	jièzhǐ	ringfor the finger
金額	jīné	amount/sum of money
今後	jīnhòu	henceforth, henceforward, from now on
金融	jīnróng	finance, banking
金屬	jīnshǔ	metals in general
儘管	jǐnguǎn	feel free to, not hesitate to
儘管	jǐnguǎn	even though, despite
緊急	jǐnjí	urgent, critical
僅僅	jǐnjǐn	only, merely, barely
儘量	jǐnliàng	to the best of one's ability
進口	jìnkǒu	import
近來	jìnlái	recently, lately
進入	jìnrù	enter, get into
近視	jìnshì	short-sighted
禁止	jìnzhǐ	prohibit, ban
精彩	jīngcǎi	brilliant, splendid
經費	jīngfèi	funds, outlay, expenses
經過	jīngguò	process, course
經理	jīnglǐ	manager, director
經歷	jīnglì	a person's past career
經歷	jīnglì	go through, undergo, experience
精力	jīnglì	energy, vigor
經濟	jīngjì	economy, financial condition
驚人	jīngrén	astonishing, amazing, alarming
精細	jīngxì	meticulous, fine, careful and attentive, thorough
驚訝	jīngyà	amazed, astounded
經驗	jīngyàn	go through, experience
經驗	jīngyàn	experience
經營	jīngyíng	manage, run, engage in
警告	jǐnggào	disciplinarywarning
警告	jǐnggào	warn, put on guard, caution, admonish
景色	jǐngsè	view, scene, landscape
敬愛	jìngài	respect and love
淨化	jìnghuà	purify
敬酒	jìngjiǔ	propose a toast
敬禮	jìnglǐ	salute, give a salute, extend one's greetings, respectfully yoursletter closure
鏡子	jìngzi	mirror
競爭	jìngzhēng	compete
糾正	jiūzhèng	correct, redress
酒吧	jiǔbā	bar
酒會	jiǔhuì	cocktail party
救火	jiùhuǒ	fire fighting, fightfire
究竟	jiùjìng	actually, exactly, after all, in the end
舅舅	jiùjiu	mother's brother, uncle
救命	jiùmìng	save sb.'s life, Help!, Save me!
就算	jiùsuàn	even if, granted that
就是	jiùshì	even if, even
就是	jiùshì	quite right, exactly, precisely
就業	jiùyè	get or take up a job
居民	jūmín	resident, inhabitant
居然	jūrán	unexpectedly, to one's surprise, going so far as to
居住	jūzhù	live, reside
鞠躬	júgōng	bowto sb.
舉辦	jǔbàn	conduct, hold, run
舉手	jǔshǒu	raise one's hands
具備	jùbèi	possess, have, be provided with
劇本	jùběn	drama, play, script
劇場	jùchǎng	theater
巨大	jùdà	huge, gigantic
聚集	jùjí	gather, assemble, collect
拒絕	jùjué	refuse, reject, decline
距離	jùlí	distance
距離	jùlí	be apart/away from
劇烈	jùliè	violent, fierce
劇情	jùqíng	story line, plot
據說	jùshuō	it is said that...
具體	jùtǐ	concrete, specific, particular
具有	jùyǒu	possess, have, be provided with
劇院	jùyuàn	theater
捐款	juānkuǎn	contribute money
捐款	juānkuǎn	contribution, donation, subscription
絕不	juébù	never
絕對	juéduì	absolutely, definitely
絕對	juéduì	absolute, perfect, definite
角色	jiǎosè	role, part
覺悟	juéwù	come to understand, realize
決心	juéxīn	determination, resolution
決心	juéxīn	decide, make up one's mind
軍隊	jūnduì	armed forces, army, troops
軍人	jūnrén	soldier, serviceman, armyman
軍事	jūnshì	military affairs
開除	kāichú	expel, discharge
開刀	kāidāo	perform/have operation, make sb. first target of attack
開發	kāifā	develop, open up, exploit
開放	kāifàng	set free, openpark, gardento public, trade with foreign nations
開戶	kāihù	open an account, establish an account
開課	kāikè	give a course, teach a subject
開朗	kāilǎng	open and clear, clear up
開明	kāimíng	enlightened, open-minded
開設	kāishè	1openshop/etc.; 2offercourse/etc.
開拓	kāituò	open up, develop, enlarge/expandterritory/etc.
開演	kāiyǎn	beginmovie/business/etc.
看家	kānjiā	look after the house, mind house, mind the house
看看	kànkan	
看來	kànlái	it seems, it looks as if
抗議	kàngyì	protest
考察	kǎochá	inspect, make on-the-spot investigation, observe and study
考卷	kǎojuàn	examination paper
考慮	kǎolǜ	think over, consider
考取	kǎoqǔ	pass entrance examination
靠近	kàojìn	be nearby, be close to
科技	kējì	science and technology
科目	kēmù	school subject/course, headings in account book, category of subjects
可靠	kěkào	reliable, trustworthy
可憐	kělián	have pity on, pity
可怕	kěpà	fearful, terrible
可是	kěshì	be indeed
渴望	kěwàng	thirst/long for
可惡	kěwù	hateful, abominable
可惜	kěxí	unfortunate
可喜	kěxǐ	gratifying, heartening
可笑	kěxiào	ridiculous, funny
課程	kèchéng	course, curriculum
客房	kèfáng	guest room
克服	kèfú	surmount, conquer, put up withhardship/etc.
客觀	kèguān	objective
客戶	kèhù	client, customer
客滿	kèmǎn	sold out, full house
課堂	kètáng	classroom
課外	kèwài	extracurricular, outside class, after school
肯定	kěndìng	affirm, approve, regard as positive
口才	kǒucái	eloquence
口號	kǒuhào	slogan, watchword
口紅	kǒuhóng	lipstick
口氣	kǒuqì	tone, note, manner of speaking, implication
口試	kǒushì	oral examination
口試	kǒushì	take an oral test
口水	kǒushuǐ	saliva
口味	kǒuwèi	a person's taste, flavor of food
口音	kǒuyīn	voice, local/regional accent
口語	kǒuyǔ	spoken/vernacular language, gossip, slander
空軍	kōngjūn	air force
空前	kōngqián	unprecedented
空中	kōngzhōng	open air/sky
恐怖	kǒngbù	fearful, horrible
恐怕	kǒngpà	perhaps
控制	kòngzhì	control, dominate, command
誇獎	kuājiǎng	crack_up, praise, resound, applaud
誇張	kuāzhāng	exaggerate, overstate
會計	kuàijì	accounting
寬度	kuāndù	width, breadth
況且	kuàngqiě	moreover, besides, in addition
擴大	kuòdà	enlarge, extend, swell, dilate
喇叭	lǎba	brass wind instrument, trumpet
辣椒	làjiāo	hot pepper, chili
蠟燭	làzhú	candle
來回	láihuí	make a round trip, go to and fro
來臨	láilín	arrive, come, approach
來往	láiwǎng	associate, contact
來往	láiwǎng	come and go
來信	láixìn	incoming letter
來源	láiyuán	source, origin
來自	láizì	come/stem/originate from
籃子	lánzi	basket
懶得	lǎnde	not feel likedoing sth., lethargic
浪費	làngfèi	waste, squander
浪漫	làngmàn	dissolute, debauched, romantic
嘮叨	láodāo	chatter, be garrulous
勞動	láodòng	do physical labor, do manual work
勞工	láogōng	laborer, worker
勞力	láolì	laborforce
牢騷	láosāo	discontent, complaint, grumble
老大	lǎodà	eldest childin a family
老公	lǎogōng	husband
老虎	lǎohǔ	tiger
老家	lǎojiā	native place, old home, one's original home
老婆	lǎopó	wife
老實	lǎoshí	honest, frank, well-behaved, good, simple-minded, naive
老是	lǎoshì	always
樂觀	lèguān	be optimistic, be hopeful
樂趣	lèqù	delight, pleasure, joy
垃圾	lèsè	rubbish, garbage, junk, crap
樂意	lèyì	be willing, be ready to
類似	lèisì	similar
冷淡	lěngdàn	treat coldly, cold-shoulder, slight
冷靜	lěngjìng	sober, calm
冷飲	lěngyǐn	cold drink
離婚	líhūn	divorce
理髮	lǐfǎ	have a haircut
理解	lǐjiě	understand, comprehend
理論	lǐlùn	theory
禮貌	lǐmào	courtesy, politeness, manners
禮品	lǐpǐn	gift, present
禮堂	lǐtáng	assembly hall, auditorium
理想	lǐxiǎng	perfect, ideal
理想	lǐxiǎng	ideal
理由	lǐyóu	reason, grounds, argument
立場	lìchǎng	position, standpoint
厲害	lìhài	great
立即	lìjí	immediately, at once, promptly
力量	lìlìàng	physical strength, power, force, ability
力氣	lìqì	physical strength
利潤	lìlùn	profit
歷史	lìshǐ	history, past records
利息	lìxí	interest
利益	lìyì	interest, benefit, profit
例子	lìzi	example, case, instance
聯合	liánhé	to unite, ally
連接	liánjiē	join, link, connect
聯絡	liánluò	contact
連絡	liánluò	contact
連忙	liánmáng	promptly, at once
連續	liánxù	continuous, successive, running
臉色	liǎnsè	complexion, look, facial expression
戀愛	liànài	love, romantic attachment
良好	liánghǎo	good, well
糧食	liángshí	grain, cereals, food
諒解	liàngjiě	understand, make allowance for
臨時	línshí	fill-in
凌晨	língchén	before dawn
靈魂	línghún	soul, spirit
靈活	línghuó	nimble, agile, flexible, elastic
零件	língjiàn	spare parts, spares, components
零售	língshòu	sellretail
零下	língxià	subzero
領帶	lǐngdài	necktie, tie
領導	lǐngdǎo	leader
領導	lǐngdǎo	lead, exercise leadership
領土	lǐngtǔ	territory
領先	lǐngxiān	be in lead, leadin competition
領袖	lǐngxiù	leader
領域	lǐngyù	territory, domain, realm, field, sphere
另外	lìngwài	in addition, besides, moreover
另外	lìngwài	another
流動	liúdòng	flow, go from place to place
流汗	liúhàn	perspire, sweat
流利	liúlì	be reluctant to leave or part with, fluent
留念	liúniàn	accept/keep as a souvenir
流血	liúxiě	bleed, shed blood
流行	liúxíng	prevalent, popular, fashionable, in vogue, spread, rageof contagious disease
留學	liúxué	study abroad
旅客	lǚkè	traveler, passenger
綠豆	lǜdòu	mung bean, green gram
律師	lǜshī	lawyer, attorney
路燈	lùdēng	street/road lamp
陸軍	lùjūn	ground/land force, army
路口	lùkǒu	crossing, intersection
錄取	lùqǔ	enroll, recruit, admit
路線	lùxiàn	route, itinerary, line
陸續	lùxù	one after another, in succession
露營	lùyíng	camp out, encamp, bivouac
錄用	lùyòng	employ
輪船	lúnchuán	steamer, steamship
輪流	lúnliú	by turns, in turn
輪胎	lúntāi	tire
輪子	lúnzi	wheel
論文	lùnwén	thesis, dissertation, treatise, paper
落後	luòhòu	fall/lay behind
落實	luòshí	fix/decide in advance, ascertain, make sure, fulfill, implement, put into effect
落伍	luòwǔ	straggle, drop out, be outdated
麻雀	máquè	sparrow
馬虎	mǎhū	be careless/casual
馬桶	mǎtǒng	nightstool, commode
碼頭	mǎtóu	wharf, dock, port city, commercial/transportation center
螞蟻	mǎyǐ	ant
買單	mǎidān	pay restaurant bill
買賣	mǎimài	do business, carry on trade
饅頭	mántóu	steamed bun
滿足	mǎnzú	be satisfied/contented, satisfy, meet
漫畫	mànhuà	caricature, cartoon
慢跑	mànpǎo	canter, jog, trot, lope
忙碌	mánglù	be busy, bustle about
盲目	mángmù	blind
毛筆	máobǐ	writing brush
矛盾	máodùn	contradictory
毛巾	máojīn	towel
貿易	màoyì	trade
玫瑰	méiguī	rose
梅花	méihuā	plum blossom, clubson playing cards, wintersweet
美觀	měiguān	pleasing to the eye
美好	měihǎo	fine, happy, glorious
美妙	měimiào	beautiful, splendid, wonderful
美術	měishù	art, beaux arts, fineart
魅力	mèilì	glamor, charm, enchantment
門票	ménpiào	entrance/admission ticket
門診	ménzhěn	outpatient service
夢到	mèngdào	to dream
夢想	mèngxiǎng	fond dream
迷糊	míhú	confused, besotted, dazed
迷路	mílù	stray, estray, lose one's way, wilder, get lost
迷人	mírén	charming, enchanting
迷失	míshī	loseone's way, etc.
迷信	míxìn	have blind faith in, make fetish of
迷信	míxìn	superstition
米粉	mǐfěn	rice flour, rice-flour noodles
蜜蜂	mìfēng	honeybee, bee
密切	mìqiè	close, intimate
棉被	miánbèi	quilt with cotton wadding
棉花	miánhuā	cotton
免得	miǎnde	so as not to, so as to avoid
免費	miǎnfèi	be free of charge, gratis
勉強	miǎnqiǎng	do with difficulty
面對	miànduì	face, confront
麵粉	miànfěn	flour, wheat flour
面積	miànjī	surface area
面臨	miànlín	be faced with, be up against
面貌	miànmào	face ,features, appearance, look, aspect
面前	miànqián	in the face of, in front of, before
面子	miànzi	reputation, face, prestige
描寫	miáoxiě	describe, depict, portray
滅亡	mièwáng	be destroyed, die out
民國	mínguó	Republic of China
民間	mínjiān	among the people, folk, nongovernmental, people-to-people
民主	mínzhǔ	democratic
民主	mínzhǔ	democracy, democratic rights
民族	mínzú	ethnic minority/group, nation, nationality
明白	míngbái	clear, obvious
名稱	míngchēng	nameof a thing or an organization
名單	míngdān	name list
明亮	míngliàng	well-lit, bright, shining
明明	míngmíng	obviously, plainly
名牌	míngpái	nameplate, name tag
名片	míngpiàn	visiting/calling card, namecard
明確	míngquè	make clear/definite
明星	míngxīng	movie/etc.star
明顯	míngxiǎn	clear, obvious
命令	mìnglìng	commend, order
命令	mìnglìng	commend, order
命運	mìngyùn	destiny, fate, lot
模仿	mófǎng	imitate, follow example of
模糊	móhú	blur, obscure, confuse
模型	móxíng	model, mold, matrix, pattern
模樣	móyàng	appearance, look
陌生	mòshēng	strange, unfamiliar
目標	mùbiāo	objective, target, goal
目錄	mùlù	catalogue, list, table of contents, directory
拿手	náshǒu	good at
哪怕	nǎpà	no matter how
奶粉	nǎifěn	powdered milk
耐心	nàixīn	patienly, persistently
耐心	nàixīn	patience, endurance
耐用	nàiyòng	wear, lasting long, durable
南部	nánbù	southern part, the south
難道	nándào	Do you really mean to say that...
難得	nándé	hard to come by, rare, seldom
南方	nánfāng	south, southern part of country
難怪	nánguài	no wonder
南面	nánmiàn	southern face, the south, the emperor
難受	nánshòu	feel bad/ill/unwell/unhappy, suffer pain
男子	nánzǐ	man, male
腦袋	nǎodài	head
腦筋	nǎojīn	brain, mind, head
腦子	nǎozi	brain, mind, head
鬧區	nàoqū	downtown
鬧鐘	nàozhōng	alarm clock
內部	nèibù	inside, interior
內行	nèiháng	adept, professional
內科	nèikē	internal medicine
內衣	nèiyī	underwear
能幹	nénggàn	able-minded, competent
能源	néngyuán	the sources of energy, energy resources, power sources
泥土	nítǔ	earth, soil, clay
年初	niánchū	beginning of year
年代	niándài	age, years, time, decade
年齡	niánlíng	age
寧可	níngkě	wouldrather, better
寧願	níngyuàn	wouldrather, better
牛排	niúpái	beefsteak
鈕扣	niǔkòu	button
農村	nóngcūn	rural area, countryside, village
濃厚	nónghòu	dense, thick, strong, pronounced
農藥	nóngyào	agricultural/farm chemical, pesticide
農業	nóngyè	agriculture, farming
女士	nǚshì	educated girl/woman, Ms., Miss
女子	nǚzǐ	woman, female
暖和	nuǎnhuo	warm, mild, sunny
暖氣	nuǎnqì	central heating
排斥	páichì	repel, exclude, reject
排隊	páiduì	stand in line
排列	páiliè	arrange, put in order
排球	páiqiú	volleyball
牌子	páizi	plaque, sign, brand, trademark, tune, person's reputation
判斷	pànduàn	judge, determine
盼望	pànwàng	long for, look forward to
跑步	pǎobù	jog, march at/on the double
泡茶	pàochá	make tea
賠償	péicháng	compensate, pay for
陪同	péitóng	accompany
培養	péiyǎng	foster, train, develop, culture
配合	pèihé	coordinate, cooperate
膨脹	péngzhàng	expand, swell, inflate
碰到	pèngdào	run into, encounter, meet
碰見	pèngjiàn	meet unexpectedly, run into
碰上	pèngshàng	come across, encounter
批判	pīpàn	appraise, judge
批評	pīpíng	criticize
皮帶	pídài	leather belt
皮膚	pífū	skin
疲倦	píjuàn	tired and sleepy
疲勞	píláo	tired, weary
脾氣	píqì	disposition, temperament, temper
皮鞋	píxié	leather shoes
屁股	pìgu	buttocks, backside, end, butt
偏食	piānshí	be particular with food
偏向	piānxiàng	be partial to
片面	piànmiàn	unilateral, one-sided
片子	piànzi	a roll of film, film, movie
騙子	piànzi	swindler, cheat
拼命	pīnmìng	risk life, make death-defying effort
貧窮	pínqióng	poor, needy
品德	pǐndé	moral character
品質	pǐnzhí	character, quality
聘請	pìnqǐng	engage, invite
平常	píngcháng	ordinary, common
平等	píngděng	equal
平衡	pínghéng	balance
平靜	píngjìng	calm, quiet, tranquil
平均	píngjūn	average
平時	píngshí	peacetime, at ordinary times, in peacetime, in normal times
平原	píngyuán	plain, flatlands
婆婆	pópó	husband's mother, mother-in-law, maternal grandmother
破壞	pòhuài	violate, destroy
破爛	pòlàn	rubbishy, ragged, frazzle, broken
破裂	pòliè	burst, split, rupture
迫切	pòqiè	urgent, pressing, imperative
撲滅	pūmiè	extirpation, extermination, eradication
普遍	pǔpiàn	universal, general, widespread, common
普及	pǔjí	popularize, disseminate, spread
普通	pǔtōng	ordinary, common, average
瀑布	pùbù	waterfall, cataract
欺負	qīfù	browbeat, take advantage of, pick on
欺騙	qīpiàn	cheat, dupe
妻子	qīzǐ	wife
其次	qícì	next, second
期間	qíjiān	time, period
旗袍	qípáo	cheongsam, a sheath with a slit skirt
齊全	qíquán	complete, all in readiness
其實	qíshí	as a matter of fact, actually, in fact
歧視	qíshì	treat with bias, despise
期限	qíxiàn	time limit, deadline
其餘	qíyú	others, the rest
旗子	qízi	flag, banner, pennant
期中	qízhōng	mid-term
起初	qǐchū	at first, originally
起飛	qǐfēi	take offof planes/etc.
起火	qǐhuǒ	fire breaking out
起來	qǐlái	[aspect] used after a verb to indicate :1an upward movement2the beginning or continuation of an action3the completion of an action or attainment of a goal
器材	qìcái	equipment, materials
氣氛	qìfēn	atmosphere, ambience
氣憤	qìfèn	angry, furious
器官	qìguān	organ, apparatus
氣候	qìhòu	climate
企圖	qìtú	attempt
企圖	qìtú	attempt, intend
氣味	qìwèi	flavor, smell
氣溫	qìwēn	air temperature
氣息	qìxí	smell, breath
氣象	qìxiàng	climatic phenomenon, prevailing spirit/atmosphere
企業	qìyè	enterprise, business
汽油	qìyóu	gasoline
簽訂	qiāndìng	conclude and signtreaty/contract/etc.
簽名	qiānmíng	sign one's name, autograph
千萬	qiānwàn	by all means, absolutely
謙虛	qiānxū	modest, unassuming
簽約	qiānyuē	sign a contract
簽字	qiānzì	initial, sign, affix one's signature, ratify
簽證	qiānzhèng	visa
前方	qiánfāng	ahead ,front direction, warfront
前進	qiánjìn	go forward
前頭	qiántóu	in the front, at the head, ahead, above, preceding
前途	qiántú	future, career, prospects
前往	qiánwǎng	go, leave for, proceed to
歉意	qiànyì	apology, regret
牆壁	qiángbì	wall
強大	qiángdà	big and powerful, formidable
強盜	qiángdào	robber, bandit
強調	qiángdiào	stress, underline
強度	qiángdù	intensity
強烈	qiángliè	strong, intense, violent
強迫	qiángpò	forcesb. to do sth.
強人	qiángrén	powerful person
搶救	qiǎngjiù	rush to save
巧妙	qiǎomiào	ingenious, skillful, clever, shrewd
悄悄	qiǎoqiǎo	quietly, stealthily
親口	qīnkǒu	from sb.'sown mouth
親戚	qīnqī	relatives
親切	qīnqiè	cordial, genial, warm
親人	qīnrén	close relatives
侵入	qīnrù	invade, intrude into
親手	qīnshǒu	with one's own hands
親眼	qīnyǎn	with one's own eyes, personally
親自	qīnzì	personally, in person, firsthand
勤勞	qínláo	industrious, hardworking
清晨	qīngchén	early morning
清除	qīngchú	eliminate, get rid of
清楚	qīngchǔ	understand clearly
輕鬆	qīngsōng	light, relaxed
輕傷	qīngshāng	minor wound
清晰	qīngxī	distinct, clearof sound/view
清醒	qīngxǐng	be sober/wide-awake
傾向	qīngxiàng	be inclined to, side with, prefer
情人	qíngrén	lover, sweetheart
情書	qíngshū	love letter
請教	qǐngjiào	seek advice, Please enlighten me.
請求	qǐngqiú	ask, request, entreat
窮人	qióngrén	poor people, the poor
秋季	qiūjì	autumn season
球場	qiúchǎng	ball field
球隊	qiúduì	ball game team
求婚	qiúhūn	make an offer of marriage, propose
球賽	qiúsài	ball game/tournament
球鞋	qiúxié	gym/tennis shoes, sneakers
球員	qiúyuán	ball team member
區別	qūbié	distinction, difference
區別	qūbié	distinguish, differentiate
區域	qūyù	region, zone, district
曲折	qūzhé	tortuous, complicated
取代	qǔdài	replace, supersede
取得	qǔdé	gain, acquire, obtain
取消	qǔxiāo	cancel, abolish, nullify
取笑	qǔxiào	ridicule, make fun of
去世	qùshì	die, pass away
全家	quánjiā	whole family
權利	quánlì	right, privilege
全面	quánmiàn	omnibearing
全面	quánmiàn	overall, comprehensive, all-round, all-out
全球	quánqiú	whole world
全體	quántǐ	whole body, plenary assembly
拳頭	quántóu	fist
缺點	quēdiǎn	defect, drawback, fault, shortcoming
缺乏	quēfá	be short of, lack
缺少	quēshǎo	lack, be short of
缺席	quēxí	be absentfrom meeting/etc.
確定	quèdìng	decide firmly, settle, determine, fix, define
確認	quèrèn	affirm, confirm, identify with certainty
確實	quèshí	definitely true/real/certain/reliable
群眾	qúnzhòng	the masses/People
然而	ránér	even so, but
燃料	ránliào	fuel
燃燒	ránshāo	burn
讓步	ràngbù	yield, compromise
熱愛	rèài	love ardently
熱烈	rèliè	ardent
熱門	rèmén	in great demand, popular
熱情	rèqíng	enthusiasm, passion
熱情	rèqíng	enthusiastic
熱心	rèxīn	warm-heartedness
人才	réncái	capable person
人格	réngé	character
人工	réngōng	manual work, manpower
人間	rénjiān	the human world
人類	rénlèi	human beings/species
人力	rénlì	manual labor, manpower
人權	rénquán	human rights
人人	rénrén	everybody
人生	rénshēng	human life
人事	rénshì	human affairs, personnel matters
人數	rénshù	number of people
人體	réntǐ	human body
人物	rénwù	character, personage, character in literature
人心	rénxīn	popular feeling, human heart
人員	rényuán	personnel, staff
忍耐	rěnnài	endure, put up with
忍受	rěnshòu	endure, bear
忍心	rěnxīn	have the heart to
任務	rènwù	assignment, job
任性	rènxìng	self-willed
仍然	réngrán	still, yet
日常	rìcháng	usual, ordinary, daily
日出	rìchū	sunrise
日後	rìhòu	in the future
融化	rónghuà	meltof snow/ice/etc.
榮幸	róngxìng	pleasure
如此	rúcǐ	thus, like this, such
如何	rúhé	how
如何	rúhé	how about it
如今	rújīn	nowadays
如同	rútóng	like, similar to
如下	rúxià	as follows
如意	rúyì	as one wishes
入口	rùkǒu	in door
入學	rùxué	start school, enter school/college
賽跑	sàipǎo	raceon foot
喪失	sàngshī	lose
掃地	sǎodì	sweep floor, reach nadir ,sweep the floor, make clean sweep
色彩	sècǎi	color, hue, shade
沙漠	shāmò	desert
沙灘	shātān	sandy beach
沙子	shāzi	sand, grit, small grains, pellets
山地	shāndì	mountainous/hilly country, hillside field
山區	shānqū	mountain area
善於	shànyú	be good at, be adept in
商標	shāngbiāo	trademark
商場	shāngchǎng	market, bazaar
傷害	shānghài	injure, harm
商量	shāngliáng	consult, talk over
商品	shāngpǐn	commodity, goods, merchandise
商人	shāngrén	businessman, merchant, trader
傷心	shāngxīn	be sad/grieved
商業	shāngyè	commerce, trade, business
上當	shàngdàng	be taken in, be fooled
上帝	shàngdì	God
上級	shàngjí	superior, higher level/authority
上升	shàngshēng	go up, rise, ascend
上市	shàngshì	go/appear on market
上頭	shàngtóu	above, on top/surface of, higher authorities
上下	shàngxià	above and below, up and down, high and low, superior and inferior, old and young, ruler and subject, heaven and earth
上衣	shàngyī	upper outer garment, jacket
上游	shàngyóu	upper reaches of river, advanced position
稍微	shāowéi	slightly, a bit
少數	shǎoshù	a few
少年	shàonián	young boy, early youth10-16
少女	shàonǚ	young girl
舌頭	shétou	tongue
捨得	shědé	be willing to give up or away
設備	shèbèi	equipment, facilities
社會	shèhuì	society
設計	shèjì	design, plan
設計	shèjì	plan, design
設立	shèlì	establish, found
攝影	shèyǐng	take a photograph, shoot a film, film
身邊	shēnbiān	at hand, nearby
身材	shēncái	stature, figure
身高	shēngāo	heightof person
深刻	shēnkè	deep, profound
深淺	shēnqiǎn	depth, seriousness
申請	shēnqǐng	apply for
深入	shēnrù	thorough, deep-going
伸手	shēnshǒu	stretch/hold out one's hand, ask for help
深夜	shēnyè	late at night
神話	shénhuà	mythology, myth, fairy tale
神經	shénjīng	nerve
神秘	shénmì	mysterious, mystical
神奇	shénqí	magical, mystical, miraculous
神氣	shénqì	spirited, vigorous, cocky, overweening, triumphant
神聖	shénshèng	sacred, holy
神仙	shénxiān	immortals, spirits, gods, the deities, supernatural beings
審查	shěnchá	examine, investigate
甚至	shènzhì	even
甚至	shènzhì	evento the point of, so much so that
慎重	shènzhòng	cautious, discreet
生產	shēngchǎn	produce, manufacture
生存	shēngcún	live, exist
生動	shēngdòng	lively, vivid
升高	shēnggāo	go up, ascend, rise
升級	shēngjí	upgrade, go upin grade/etc., escalate
生命	shēngmìng	life
生肖	shēngxiào	year of the animal in which one was born
升學	shēngxué	enter higher school
生長	shēngzhǎng	grow, develop
繩子	shéngzi	rope, string
省得	shěngde	lest
省錢	shěngqián	save money, be economical
勝利	shènglì	win victory/success
剩下	shèngxià	be leftover, remain
失敗	shībài	be defeated, fail, lose
失掉	shīdiào	lose, miss
師父	shīfu	honorific term of address for a Buddhist monk or nun, or a Taoist priest or nun
師傅	shīfù	master worker, tutor of king/emperor, general term of address in late 70s and 80s, address for service workers
施工	shīgōng	work onof construction
失戀	shīliàn	lovelorn, be jilted, lose one's love
失眠	shīmián	sleepless, suffer from insomnia
師母	shīmǔ	wife of one's teacher/master
失去	shīqù	lose
詩人	shīrén	poet
失望	shīwàng	become disappointed, losehope/faith
失業	shīyè	lose one's job, be out of work
獅子	shīzi	lion
時常	shícháng	often, frequently
實話	shíhuà	truth, truthful statement
時機	shíjī	an occasion, a suitableor righttime, opportune moment
實際	shíjì	practical, literal
時刻	shíkè	time, moment
實力	shílì	actual strength
食品	shípǐn	foodstuff, food
時期	shíqí	periodof time
實施	shíshī	put into effect, implement
時時	shíshí	often, constantly
實現	shíxiàn	realize, achieve, bring about
實行	shíxíng	put into practice/effect, practice
實驗	shíyàn	experiment, test
實驗	shíyàn	test, experiment
實用	shíyòng	practical, pragmatic, functional
實在	shízài	indeed, really, honestly, in fact, as a matter of fact
實在	shízài	true, real, honest, dependable
使得	shǐde	make, cause
始終	shǐzhōng	always, from beginning to end
適當	shìdàng	suitable, proper
是非	shìfēi	right and wrong, quarrel, dispute
是否	shìfǒu	whether or not, is it so or not
適合	shìhé	suit, fit
世紀	shìjì	century
勢力	shìlì	power, force, influence
市立	shìlì	city-established, municipal
市民	shìmín	citizenry, townspeople
市區	shìqū	city proper, urban district
示威	shìwēi	put on show of force, demonstrate, march
事物	shìwù	thing, object
事先	shìxiān	in advance, beforehand
試驗	shìyàn	attempt, experiment, test
式樣	shìyàng	style, type, model
視野	shìyě	field of vision
事業	shìyè	undertaking, enterprise, facilities
適應	shìyìng	suit, adapt, fit, get used to
適用	shìyòng	suit, be applicable
市長	shìzhǎng	mayor
收穫	shōuhuò	harvest, gains, results
收據	shōujù	receipt
收看	shōukàn	tune into, watche.g.,TV
收入	shōurù	income
收拾	shōushí	put in order, tidy up
首都	shǒudū	capitalof country
手段	shǒuduàn	means, method, trick, artifice
手工	shǒugōng	handwork
手術	shǒushù	operation
首先	shǒuxiān	first
手續	shǒuxù	procedure
受到	shòudào	be given
壽命	shòumìng	life
受傷	shòushāng	be injured/wounded
蔬菜	shūcài	vegetables, greens
書法	shūfǎ	calligraphy, penmanship
書房	shūfáng	study, studio
疏忽	shūhū	ignore, neglect
書籍	shūjí	books
輸入	shūrù	import, input
舒適	shūshì	comfortable, cozy
熟練	shúliàn	skilled, practiced, proficient
熟人	shúrén	acquaintance, friend
叔叔	shúshu	father's younger brother, uncle, unclechild's address for young males
熟悉	shúxī	know sth./sb. well
暑期	shǔqí	summer vacation time
屬於	shǔyú	belong to, be part of
數量	shùliàng	quantity, amount
樹林	shùlín	woods, grove
樹木	shùmù	trees
數目	shùmù	number, amount
樹葉	shùyè	leavesof trees
數字	shùzì	numeral, figure, digit, quantity, amount
刷卡	shuākǎ	pay by credit card
刷子	shuāzi	brush
摔倒	shuāidǎo	fall down, fell an opponent
率領	shuàilǐng	lead, head
雙方	shuāngfāng	both sides, two parties
水平	shuǐpíng	standard, level
水災	shuǐzāi	flood, inundation
水準	shuǐzhǔn	level, standard
說服	shuìfú	persuade, talk sb. over
睡著	shuìzháo	fall asleep
順便	shùnbiàn	conveniently, in passing
順利	shùnlì	smooth, successful, without a hitch
順手	shùnshǒu	smoothly, easily, without extra trouble
順序	shùnxù	sequence, order
說法	shuōfǎ	way of saying sth., wording, formulation, statement, version, argument
司機	sījī	driver
思考	sīkǎo	ponder over, reflect on
私立	sīlì	privately run, private
思索	sīsuǒ	think deeply, ponder
私人	sīrén	private
思想	sīxiǎng	thought, thinking, idea, ideology
死亡	sǐwáng	be dead/doomed
四處	sìchù	all around, on all sides, on every side
四處	sìchù	all around, everywhere
四方	sìfāng	four directions, all sides, square
似乎	sìhū	it seems, as if, seemingly
四季	sìjì	four seasons, each season consisting of three months
寺廟	sìmiào	temple
飼養	sìyǎng	raiseanimals/etc.
送行	sòngxíng	see sb. off, wish sb. bon voyage
俗話	súhuà	common saying, proverb
速度	sùdù	speed, velocity, tempo, rate, pace
算了	suànle	Forget about it., That's enough!
算是	suànshì	considered to be
算帳	suànzhàng	make out bills, settle accounts, reckon ,square accounts, balance the books, get even with sb.
隨手	suíshǒu	conveniently, without extra trouble
隨意	suíyì	as one pleases
歲數	suìshù	age, years
孫女	sūnnǚ	granddaughter
孫子	sūnzi	son's son, grandson
損失	sǔnshī	loss
損失	sǔnshī	lose
縮短	suōduǎn	shorten, curtail, cut down
縮水	suōshuǐ	contract, shrink, withdraw, recoil
所謂	suǒwèi	so-called
抬頭	táitóu	raise one's head, gain ground, improve, go upin price
談話	tánhuà	talk, chat
談判	tánpàn	negotiate, talk
毯子	tǎnzi	blanket
探親	tànqīn	visit family
逃避	táobì	escape, evade, shirk
陶瓷	táocí	ceramics
淘氣	táoqì	naughty
桃子	táozi	peach
逃走	táozǒu	run away, flee
特別	tèbié	specially, particularly, especially
特地	tèdì	on purpose, specially
特點	tèdiǎn	characteristic, peculiarity, trait
特色	tèsè	a characteristic, a distinguishing feature, a character
特殊	tèshū	exceptional, special, particular, peculiar, distinctive
題材	tícái	subject matter, theme
提到	tídào	submit, present
題目	tímù	title, subject, topic, exam questions
提起	tíqǐ	mention, speak of
提前	tíqián	advance in date, ahead
提醒	tíxǐng	remind, warn, alert to
提早	tízǎo	in advance
體會	tǐhuì	know/learn from experience, try to realizeanother's situation
體力	tǐlì	physical power/strength
體貼	tǐtiē	be considerate, be thoughtful
體溫	tǐwēn	bodytemperature
體重	tǐzhòng	bodyweight
天才	tiāncái	genius, talent, gift
天空	tiānkōng	sky, heaven
天然	tiānrán	natural
天堂	tiāntáng	paradise, heaven
天文	tiānwén	astronomy
天下	tiānxià	world, everywhere under heaven;domination
天真	tiānzhēn	naive, innocent
甜點	tiándiǎn	dessert, sweetmeat
田野	tiányě	field, open country
挑選	tiāoxuǎn	choose, select
條件	tiáojiàn	condition, term, factor, requirement, prerequisite ,qualification
條約	tiáoyuē	treaty, pact
調整	tiáozhěng	adjust, readjust, regulate, restructure, balance
挑戰	tiǎozhàn	challenge to battle/contest
跳高	tiàogāo	high jump
跳遠	tiàoyuǎn	do long jump, do broad jump
鐵路	tiělù	railway, railroad
聽見	tīngjiàn	hear
聽力	tīnglì	hearing, aural comprehensionin language teaching
聽眾	tīngzhòng	audience, listeners
停電	tíngdiàn	cut power
停止	tíngzhǐ	stop, cease, halt, suspend, call off
投票	tóupiào	vote, cast a vote
投入	tóurù	throw/put into
頭痛	tóutòng	have a headache
投降	tóuxiáng	surrender, capitulate
投資	tóuzī	investment
投資	tóuzī	invest
通常	tōngcháng	generally, usually, normally
通過	tōngguò	adopt, pass, carrymotion/legislation
通信	tōngxìn	communicate by letter, correspond
通訊	tōngxùn	communication, news report, newsletter
同胞	tóngbāo	offspring of same parents, compatriot
同情	tóngqíng	sympathize with
同事	tóngshì	colleague, fellow worker
同志	tóngzhì	comrade
統計	tǒngjì	add up, count
統一	tǒngyī	unify, unite, integrate
統治	tǒngzhì	dominate, rule
痛快	tòngkuài	joyful, delighted, to one's heart's content, forthright
突出	túchū	outstanding
突出	túchū	give prominence to, stress
突破	túpò	breakthrough, penetration
突破	túpò	make a breakthrough, surmount
突然	túrán	suddenly, abruptly
圖書	túshū	books
圖章	túzhāng	seal, stamp
兔子	tùzi	rabbit, hare
團結	tuánjié	unite, rally
團體	tuántǐ	organization, group, team
團圓	tuányuán	reunion
推動	tuīdòng	push forward, promote
推翻	tuīfān	overthrow
推廣	tuīguǎng	popularize, spread, extend
推薦	tuījiàn	recommend
推銷	tuīxiāo	promote sale of, peddle
退步	tuìbù	degenerate, backslide, regress, decline, step backward, retrogress
退出	tuìchū	withdraw from, quit
退回	tuìhuí	return, send/give back
退休	tuìxiū	to retire, to go into retirement, to step down
脫離	tuōlí	separate oneself from
拖鞋	tuōxié	slippers, sandals, flip-flops
妥善	tuǒshàn	appropriate, proper
妥協	tuǒxié	come to terms, compromise
娃娃	wáwa	baby, child, doll
外部	wàibù	outside, exterior, surface
外出	wàichū	go out
外地	wàidì	place other than where one is
外觀	wàiguān	outward appearance, exterior
外行	wàiháng	unprofessional
外匯	wàihuì	foreign exchange
外交	wàijiāo	diplomacy, foreign affairs
外界	wàijiè	external/outside world, outside
外科	wàikē	surgery
外婆	wàipó	maternal grandmother
外頭	wàitou	outside, out
彎腰	wānyāo	bow, hunch, stoop, double over
完畢	wánbì	finish, complete
玩具	wánjù	toy, plaything
完善	wánshàn	perfect, consummate
玩笑	wánxiào	joke, jest
完整	wánzhěng	complete, integrated, intact
晚輩	wǎnbèi	younger generation, one's juniors
萬一	wànyī	just in case, if by any chance
網路	wǎnglù	network
往往	wǎngwǎng	often, frequently
威脅	wēixié	threat
威脅	wēixié	threaten, menace, imperil
維持	wéichí	keep, preserve
違反	wéifǎn	violate, transgress, infringe
維護	wéihù	safeguard, defend, uphold
危機	wéijī	crisis
為難	wéinán	create difficultiesfor sb., be in a quandary
微笑	wéixiào	smile
唯一	wéiyī	only, sole
為主	wéizhǔ	give first place to
尾巴	wěiba	tail
偉大	wěidà	great, mighty
委託	wěituō	authorize, commend, consign
委員	wěiyuán	committee member
未婚	wèihūn	unmarried, single
味精	wèijīng	monosodium glutamate, MSG
為了	wèile	for, for the sake of, in order to
衛生	wèishēng	hygienic
慰問	wèiwèn	comfort, console, convey sympathy/greetings
衛星	wèixīng	satellite
位於	wèiyú	be located/situated
位置	wèizhì	seat, place, position
溫度	wēndù	temperature
溫暖	wēnnuǎn	warm, warm up
溫柔	wēnróu	gentle and soft
文法	wénfǎ	grammar, syntax
文件	wénjiàn	documents, file
文具	wénjù	writing material, writing materials, stationery
文物	wénwù	cultural/historical objects/relics
文藝	wényì	literature and art
蚊子	wénzi	mosquito
穩定	wěndìng	stable, steady
問好	wènhǎo	send one's regards to, say hello to
問候	wènhòu	send one's respects/regards to
臥房	wòfáng	bedroom
臥室	wòshì	bedroom
污染	wūrǎn	pollute, contaminate
無法	wúfǎ	unable to, cannot
無論	wúlùn	no matter what/how/etc., regardless
無情	wúqíng	merciless, ruthless
無窮	wúqióng	infinite, endless, inexhaustible
無數	wúshù	innumerable, countless
無限	wúxiàn	infinite, limitless
無意	wúyì	have no intention to
舞蹈	wǔdào	dance
舞會	wǔhuì	danceparty, ball
武器	wǔqì	weapon, arms
舞廳	wǔtīng	ballroom, dance hall
誤點	wùdiǎn	overdue, be late, be behind schedule, behind schedule, lose, late, delay
誤會	wùhuì	misunderstand, mistake
誤會	wùhuì	misunderstanding
物價	wùjià	commodity prices
物理	wùlǐ	physics
物質	wùzhí	matter, substance, material
西北	xīběi	northwest, the Northwest
西部	xībù	western part, the west
吸毒	xīdú	take drugs
西方	xīfāng	west
西南	xīnán	southwest, the Southwest
吸取	xīqǔ	absorb, draw, assimilate
犧牲	xīshēng	sacrifice oneself, die martyr's death, do sth. at the expense of self or sb. else
吸食	xīshí	suck, take inliquids/narcotics/etc
吸收	xīshōu	absorb, suck up, assimilate, recruit
吸煙	xīyān	smoke, smoking
吸引	xīyǐn	attract, draw, fascinate
西裝	xīzhuāng	Western-style clothes
媳婦	xífù	daughter-in-law, wife of sb. of younger generation
喜愛	xǐài	like, love, be fond of
喜酒	xǐjiǔ	liquor drunk at wedding feast, wedding feast
細胞	xìbāo	cell
細節	xìjié	details, particulars
戲劇	xìjù	drama, play, theater
細菌	xìjùn	germ, bacterium
系列	xìliè	series, set
系統	xìtǒng	system
細小	xìxiǎo	tiny
細心	xìxīn	careful, attentive
蝦米	xiāmǐ	dried, shelled shrimp, small shrimp
下巴	xiàbā	lower jaw, chin
夏季	xiàjì	summer
下降	xiàjiàng	descend, go/come down, drop, fall, decline
下來	xiàlái	used after a verb to indicate motion toward a lower or nearer position
下棋	xiàqí	play chess
下去	xiàqù	[aspect]go on , continueused after a verb
下游	xiàyóu	lower reachesof river
鮮花	xiānhuā	fresh flower
現金	xiànjīn	ready money, cash, cash reserve in bank
先進	xiānjìn	advance
鮮奶	xiānnǎi	fresh milk
鮮血	xiānxiě	fresh blood
顯得	xiǎnde	seem, look, appear
顯然	xiǎnrán	obviously, evidently, clearly
顯示	xiǎnshì	show, display, demonstrate, manifest
顯著	xiǎnzhù	notable, marked, striking, remarkable, outstanding
現場	xiànchǎng	sceneof an incident, site, spot
現成	xiànchéng	ready-made
現代	xiàndài	modern
羨慕	xiànmù	admire, envy
現實	xiànshí	reality, actuality
現實	xiànshí	practical, pragmatic
現象	xiànxiàng	phenomenon, appearance
限制	xiànzhì	restrictiveness
限制	xiànzhì	restrict, confine
鄉村	xiāngcūn	village, countryside, rural area
香腸	xiāngcháng	sausage
相當	xiāngdāng	quite, fairly, considerably
相當	xiāngdāng	correspond to, be equal to, match, balance
相對	xiāngduì	be opposite, be face to face
相反	xiāngfǎn	opposite, contrary, reverse
相關	xiāngguān	be interrelated
相互	xiānghù	mutually, reciprocally
香蕉	xiāngjiāo	banana
相似	xiāngsì	resemble, be similar/alike
香水	xiāngshuǐ	perfume, scent
相同	xiāngtóng	be identical/alike
詳細	xiángxì	detailed, minute
想到	xiǎngdào	think of, call to mind
想念	xiǎngniàn	remember with longing, miss
享受	xiǎngshòu	enjoy
想像	xiǎngxiàng	imagination
想像	xiǎngxiàng	imagine, fancy, visualize
響應	xiǎngyìng	respond, answer
享有	xiǎngyǒu	enjoyright/etc.
相機	xiàngjī	camera
向來	xiànglái	always, all along
項目	xiàngmù	item, article, clause, project
相親	xiàngqīn	get look at prospective spouse
相聲	xiàngshēng	cross talk, comic dialogue
巷子	xiàngzi	lane, alley
消除	xiāochú	to eliminate, to clear, to remove, to clear up
消費	xiāofèi	expenditure
消費	xiāofèi	consume
消化	xiāohuà	digest
消極	xiāojí	negative, passive, inactive
銷路	xiāolù	sales, market
消滅	xiāomiè	perish, die out, pass away, eliminate, abolish, exterminate
消失	xiāoshī	disappear, vanish, dissolve
銷售	xiāoshòu	sell, market
小便	xiǎobiàn	to urinate
小吃	xiǎochī	snack, refreshment, cold/prepared dish
曉得	xiǎode	know
小費	xiǎofèi	tip, gratuity
小麥	xiǎomài	wheat
小氣	xiǎoqì	stingy
小子	xiǎozi	bloke, boy, guy, fellow
小組	xiǎozǔ	group
校車	xiàochē	school bus
效果	xiàoguǒ	effect, result
效率	xiàolǜ	efficiency
笑容	xiàoróng	a smile, a smiling face
孝順	xiàoshùn	show filial obedience
校友	xiàoyǒu	alumnus, alumna
校園	xiàoyuán	schoolyard, campus
協助	xiézhù	assist, help
血管	xiěguǎn	blood vessel
血型	xiěxíng	blood group/type
血液	xiěyè	blood
心得	xīndé	what one has learned from work/study/etc.
新郎	xīnláng	bridegroom
心理	xīnlǐ	psychology, mentality
新娘	xīnniáng	bride
欣賞	xīnshǎng	appreciate, enjoy, admire
新生	xīnshēng	new student
新式	xīnshì	new-style
薪水	xīnshuǐ	salary, wages
心跳	xīntiào	flutter
新鮮	xīnxiān	fresh
心意	xīnyì	regard, kindly feeling, intention, purpose
心臟	xīnzàng	heart
信號	xìnhào	signal
信任	xìnrèn	trust, have confidence in
信仰	xìnyǎng	belief
信仰	xìnyǎng	believe
信用	xìnyòng	trustworthiness, credit
興奮	xīngfèn	excited
星光	xīngguāng	starlight
形成	xíngchéng	take shape, form
行程	xíngchéng	route/distance of travel, itinerary, travel
行動	xíngdòng	action, operation
行動	xíngdòng	move/get about, act, take action
行李	xínglǐ	luggage, baggage
行人	xíngrén	pedestrian
形容	xíngróng	describe
形式	xíngshì	form, shape
行為	xíngwéi	action, behavior, conduct
形象	xíngxiàng	image, form, figure, imagery
形狀	xíngzhuàng	form, appearance, shape
醒來	xǐnglái	wake up
性別	xìngbié	sexual distinction, sex
幸福	xìngfú	happy
性格	xìnggé	nature, disposition, temperament
幸好	xìnghǎo	fortunately, luckily
幸虧	xìngkuī	fortunately, luckily
幸運	xìngyùn	very fortunate, lucky
性質	xìngzhí	quality, nature, character
熊貓	xióngmāo	panda
雄偉	xióngwěi	imposing, magnificent
修改	xiūgǎi	revise, amend, alter
休假	xiūjià	have holiday/vacation/leave
修理	xiūlǐ	repair, mend, fix
休閒	xiūxián	lie fallow
修正	xiūzhèng	revise, amend, correct
需求	xūqiú	requirement, demand
須知	xūzhī	points for attention, notice
許願	xǔyuàn	wish
宣傳	xuānchuán	propagandist, publicist
宣傳	xuānchuán	propagate, disseminate, give publicity to
選舉	xuǎnjǔ	election
選手	xuǎnshǒu	player selected as contestant, athlete
學會	xuéhuì	learned society, scholarlyassociation
學會	xuéhuì	learn, master
學歷	xuélì	record of formal schooling
學術	xuéshù	learning, science
學位	xuéwèi	academic degree, degree
學問	xuéwèn	learning, knowledge, scholarship
學業	xuéyè	one's studies, schoolwork
學院	xuéyuàn	college, academy, institute
學者	xuézhě	scholar
雪花	xuěhuā	snowflake
削減	xuèjiǎn	cut down, reduce
循環	xúnhuán	circulate, cycle
尋找	xúnzhǎo	seek, look for
訓練	xùnliàn	training
訓練	xùnliàn	train, drill
迅速	xùnsù	rapid, speedy, prompt
押金	yājīn	deposit
壓力	yālì	pressure
壓迫	yāpò	oppress, repress, constrict
牙膏	yágāo	toothpaste
煙火	yānhuǒ	fireworks
鹽巴	yánbā	salt
延長	yáncháng	lengthen, prolong, extend
嚴格	yángé	strict, rigorous
嚴肅	yánsù	serious, solemn
演唱	yǎnchàng	sing in performance
演出	yǎnchū	show, perform
掩蓋	yǎngài	cover
眼光	yǎnguāng	eye, sight, foresight, insight, vision, view, way of looking at things
演講	yǎnjiǎng	lecture, make speech
眼淚	yǎnlèi	tears
眼前	yǎnqián	before one's eyes
演員	yǎnyuán	performer
演奏	yǎnzòu	give instrumental performance
宴會	yànhuì	banquet, dinner party
厭惡	yànwù	detest, be disgusted with
陽傘	yángsǎn	parasol, sunshade
氧氣	yǎngqì	oxygen
樣品	yàngpǐn	sampleproduct, specimen
邀請	yāoqǐng	invite
搖擺	yáobǎi	sway, swing, oscillate
搖頭	yáotóu	shake one's head
要不	yàobù	otherwise, or else, or
藥方	yàofāng	prescription
藥房	yàofáng	drugstore, pharmacy, hospital pharmacy, dispensary
要命	yàomìng	darned, kill, drive sb. to death
藥水	yàoshuǐ	liquid medicine, lotion
藥物	yàowù	drugs, medicine
野餐	yěcān	picnic
也好	yěhǎo	1no matter whether, may as well, that's fine; 2particle: showing hesitant acceptance
野獸	yěshòu	wild animal
野心	yěxīn	wild ambition, careerism
夜市	yèshì	night market
夜晚	yèwǎn	evening
業務	yèwù	professional work, business
業餘	yèyú	amateur
葉子	yèzi	leaf
衣櫃	yīguì	dresser
依據	yījù	basis, foundation
依靠	yīkào	rely/depend on
依然	yīrán	still, as before
衣裳	yīshang	clothing, clothes
醫師	yīshī	doctor
醫學	yīxué	medical science, medicine
一一	yīyī	one by one, one after another
一帶	yídài	district, region
移動	yídòng	move, shift
一面	yímiàn	along, while
移民	yímín	emigrate
儀器	yíqì	instrument, apparatus
儀式	yíshì	ceremony, rite
疑問	yíwèn	question, doubt
一向	yíxiàng	consistently, all along, up to now
一再	yízài	time and again, again and again
一致	yízhì	identical, unanimous
以便	yǐbiàn	so that, in order to
以及	yǐjí	and
以來	yǐlái	since
以免	yǐmiǎn	in order to avoid, so as not to
以內	yǐnèi	within, less than
以上	yǐshàng	above
以上	yǐshàng	the above/foregoing/above-mentioned
以外	yǐwài	beyond, outside, other than, except
以往	yǐwǎng	before, formerly, in the past
以下	yǐxià	under the condition of, under, beneath, below
以下	yǐxià	the following, hereafter
一般	yìbān	generally
議會	yìhuì	parliament, legislative assembly
一連	yìlián	successively, in succession, running
一旁	yìpáng	side
一齊	yìqí	simultaneously, in unison, together
一生	yìshēng	all/throughout one's life
一時	yìshí	for a time, temporarily, a moment
意識	yìshì	consciousness, mentality
藝術	yìshù	art
一同	yìtóng	together
意外	yìwài	accident, mishap
意外	yìwài	unexpected, unforeseen
義務	yìwù	duty, obligation, volunteer duty
意義	yìyì	meaning, sense, significance
意志	yìzhì	will, determination
因此	yīncǐ	therefore, consequently
因素	yīnsù	factor, element
音響	yīnxiǎng	stereo, hi-fi
引發	yǐnfā	evoke
引起	yǐnqǐ	give rise to, lead to
飲食	yǐnshí	food and drink, diet
印刷	yìnshuā	print
印象	yìnxiàng	impression
印章	yìnzhāng	seal, signet, stamp
應當	yīngdāng	should, ought to
嬰兒	yīngér	baby, infant
應該	yīnggāi	right, proper
英俊	yīngjùn	handsome
英雄	yīngxióng	hero
贏得	yíngdé	win, gain
迎接	yíngjiē	meet, welcome
營養	yíngyǎng	nutritive, alimental
營養	yíngyǎng	nutrition, nourishment
營業	yíngyè	do business
影本	yǐngběn	copy
影片	yǐngpiàn	film, movie
影印	yǐngyìn	print by photo-offset, photocopy
影子	yǐngzi	shadow, trace, sign, vague impression
應付	yìngfù	deal/cope with, handle, do sth. perfunctorily, make do
應邀	yìngyāo	receive an invitation
應用	yìngyòng	apply, use
優點	yōudiǎn	merit, strong/good point, advantage
優惠	yōuhuì	give preferential/special treatment
優良	yōuliáng	fine, good
優美	yōuměi	graceful, exquisite
幽默	yōumò	humor
優秀	yōuxiù	outstanding, excellent
優越	yōuyuè	superior, outstanding
郵差	yóuchāi	postman
郵件	yóujiàn	postal items, post, mail
遊客	yóukè	tourist, sightseer
遊戲	yóuxì	recreation, game
遊戲	yóuxì	play
遊行	yóuxíng	parade, march, demonstrate
由於	yóuyú	owing/due/thanks to
有關	yǒuguān	with regard to
有關	yǒuguān	be related
友好	yǒuhǎo	friendly, amicable
有力	yǒulì	strong, forceful, powerful
有利	yǒulì	be advantageous/beneficial
有時	yǒushí	sometimes, at times
有效	yǒuxiào	efficacious, effective, valid
有些	yǒuxiē	somewhat, rather
有些	yǒuxiē	some
友誼	yǒuyí	friendship
擁抱	yōngbào	embrace
勇敢	yǒnggǎn	brave, courageous
擁護	yǒnghù	support, endorse
擁擠	yōngjǐ	crowded, pushed and squeezed together
勇氣	yǒngqì	courage, nerve
擁有	yǒngyǒu	possess, have, own
用處	yòngchù	use, practical application
用法	yòngfǎ	use, usage
用具	yòngjù	utensil, appliance
用力	yònglì	exert selfphysically
用品	yòngpǐn	articles for use
用心	yòngxīn	be diligent/attentive
愉快	yúkuài	be happy, be cheerful
娛樂	yúlè	amusement, entertainment, recreation
於是	yúshì	thereupon, hence, consequently, as a result
語調	yǔdiào	intonation
與其	yǔqí	rather than
語氣	yǔqì	tone, manner of speaking, mood, modality
雨衣	yǔyī	raincoat
語音	yǔyīn	speech sounds, speech sounds, spokenvs. writtenpronunciation of characters
預報	yùbào	forecast
預定	yùdìng	predetermine, schedule
預計	yùjì	predict, expect
遇見	yùjiàn	meet, come across
預算	yùsuàn	budget
浴室	yùshì	bathroom, shower room
預先	yùxiān	in advance, beforehand
允許	yǔnxǔ	permit, allow
運氣	yùnqì	fortune, luck
運送	yùnsòng	transport, convey
運輸	yùnshū	transport
運用	yùnyòng	utilize, wield, apply
運轉	yùnzhuǎn	revolve, turn round, work, operate
冤枉	yuānwǎng	treat unjustly
元旦	yuándàn	New Year's Day
員工	yuángōng	staff, personnel
緣故	yuángù	reason, cause
原來	yuánlái	original
原理	yuánlǐ	principle, tenet
原料	yuánliào	raw material
圓滿	yuánmǎn	satisfactory
原始	yuánshǐ	original, firsthand, primeval, primitive
原先	yuánxiān	originally, at first
圓形	yuánxíng	circular shape
原則	yuánzé	principle
遠大	yuǎndà	great
願望	yuànwàng	desire, wish, aspiration
約好	yuēhǎo	come to an agreement
約會	yuēhuì	make an appointment
約會	yuēhuì	appointment, engagement, date
月餅	yuèbǐng	moon cake
月底	yuèdǐ	the end of the month
閱讀	yuèdú	read
月份	yuèfèn	month
月光	yuèguāng	moonlight, moonbeam
樂器	yuèqì	musical instrument
月球	yuèqiú	moon
樂團	yuètuán	philharmonic society/orchestra
雜誌	zázhì	magazine, journal, periodical
災害	zāihài	calamity, disaster
災難	zāinàn	calamity, misfortune
再度	zàidù	once more/again, second time
在乎	zàihū	care about, mind
再說	zàishuō	furthermore, besides
在意	zàiyì	pay attention to
在於	zàiyú	be at/in/on, depend on, rest with
咱們	zánmen	we, you and I
贊成	zànchéng	approve, endorse, assist
讚美	zànměi	praise, eulogize
葬禮	zànglǐ	funeral rites, funeral
遭到	zāodào	meet with, encounter
糟糕	zāogāo	What a mess! ; Too bad!
遭受	zāoshòu	suffer
遭遇	zāoyù	vicissitudes of life
早晨	zǎochén	early morning
早點	zǎodiǎn	in advance, a bit earlier
早點	zǎodiǎn	breakfast
早期	zǎoqí	early stage/phase
早日	zǎorì	at an early date, early, soon
早晚	zǎowǎn	sooner or later
早已	zǎoyǐ	long ago/since
造成	zàochéng	create, bring about
造句	zàojù	make a sentence
噪音	zàoyīn	noise
責任	zérèn	duty, responsibility
增長	zēngzhǎng	become longer
贈品	zèngpǐn	giveway, gift
贈送	zèngsòng	present as gift
展出	zhǎnchū	exhibit
展開	zhǎnkāi	launch, develop
展覽	zhǎnlǎn	exhibition
展覽	zhǎnlǎn	exhibit, show, display
展示	zhǎnshì	reveal, lay bare
戰場	zhànchǎng	battlefield
暫時	zhànshí	temporarily
戰爭	zhànzhēng	war, warfare
站住	zhànzhù	stop
漲價	zhǎngjià	rise in price
掌聲	zhǎngshēng	clapping, applause
掌握	zhǎngwò	grasp, master, have in hand, control
障礙	zhàngài	obstacle, barrier
帳單	zhàngdān	reckoning, tab, invoice, account, bill, check, chit
丈夫	zhàngfū	husband
招待	zhāodài	receiveguests, servecustomers
招呼	zhāohū	say hello to
招牌	zhāopái	shop sign, signboard
招手	zhāoshǒu	beckon, wave, wave one's hand
照常	zhàocháng	as usual
召開	zhàokāi	convene, convoke
折合	zhéhé	convert into, amount to
折扣	zhékòu	discount, rebate
折磨	zhémó	persecute, torment
哲學	zhéxué	philosophy
真的	zhēnde	really, truly, indeed
針對	zhēnduì	in the light of, in connection with
珍貴	zhēnguì	valuable, precious
真理	zhēnlǐ	truth
真實	zhēnshí	true, real, authentic, factual
真是	zhēnshì	really
偵探	zhēntàn	detective, spy
真心	zhēnxīn	true heart, sincerity
真心	zhēnxīn	sincere, genuine, true
枕頭	zhěntóu	pillow
震動	zhèndòng	shake, shock, vibrate
陣子	zhènzi	period of time
睜開	zhēngkāi	openthe eyes
爭論	zhēnglùn	controvert, dispute
徵求	zhēngqiú	solicit, seek
爭取	zhēngqǔ	strive/fight for
正月	zhēngyuè	first month of lunar year
整潔	zhěngjié	clean and tidy, neat
整理	zhěnglǐ	put in order, arrange
整數	zhěngshù	integer, whole number, r ound number/figure
政策	zhèngcè	policy
政黨	zhèngdǎng	political party
政府	zhèngfǔ	government
正好	zhènghǎo	just right, at the right moment
正好	zhènghǎo	just, exactly
證件	zhèngjiàn	credentials, papers, document, certificate
正經	zhèngjīng	serious
證據	zhèngjù	evidence, proof, testimony
正面	zhèngmiàn	obverse/right side, front, facade
證明	zhèngmíng	certificate, identification, testimonial, proof
證明	zhèngmíng	prove, testify, bear out
證實	zhèngshí	confirm, verify
正式	zhèngshì	formalof actions/speeches/etc.
證書	zhèngshū	certificate, credentials
政治	zhèngzhì	politics, political affairs
症狀	zhèngzhuàng	symptom
支持	zhīchí	support, stand by, back up
支出	zhīchū	to spend, to disburse
之後	zhīhòu	later, behind, at the back of, after
之間	zhījiān	the midst of
之間	zhījiān	among, between
支票	zhīpiào	bankcheck
知識	zhīshì	knowledge
支援	zhīyuán	support, assist, help
直到	zhídào	until, up to
直接	zhíjiē	direct, immediate
職位	zhíwèi	position, post
植物	zhíwù	plant, flora
直線	zhíxiàn	sharprise or fall
執行	zhíxíng	carry out, execute
職業	zhíyè	occupation, profession, vocation
職員	zhíyuán	office worker, staff member, functionary
指出	zhǐchū	point outthat
指導	zhǐdǎo	guide, direct
指定	zhǐdìng	appoint, assign
指示	zhǐshì	directive, instructions
指示	zhǐshì	indicate, point out, instruct
只是	zhǐshì	however, but then
只是	zhǐshì	merely, only, just, simply be
只有	zhǐyǒu	only, alone
紙張	zhǐzhāng	paper
制定	zhìdìng	formulate, draft
制度	zhìdù	system, institution
智慧	zhìhuì	wisdom, intelligence
志氣	zhìqì	aspiration, ambition
至少	zhìshǎo	attheleast
秩序	zhìxù	order
至於	zhìyú	as for/to
志願	zhìyuàn	aspiration, wish, ideal
製造	zhìzào	make, manufacture, engineer, create, fabricate
製作	zhìzuò	make, manufacture
制止	zhìzhǐ	curb, prevent, stop
中部	zhōngbù	the midland, central section, middle
中級	zhōngjí	intermediate
中年	zhōngnián	middle age
中途	zhōngtú	halfway, midway
中央	zhōngyāng	central authoritiesof state/party/etc.
中藥	zhōngyào	traditional Chinese medicine
終於	zhōngyú	at long last, finally, all things considered, on the whole
種類	zhǒnglèi	kind, type, variety
種子	zhǒngzǐ	seed
種族	zhǒngzú	race, ethnic group
重大	zhòngdà	great, weighty, major, significant
重點	zhòngdiǎn	focal point, stress, emphasis
中毒	zhòngdú	poison, taint, be poisoned
重量	zhòngliàng	weight
重傷	zhòngshāng	severely injured
重傷	zhòngshāng	serious wound
重視	zhòngshì	attach importance to, take sth. seriously, value
重心	zhòngxīn	center of gravity, heart, core, focus
周到	zhōudào	thoughtful
周圍	zhōuwéi	vicinity, surrounding, all around
逐漸	zhújiàn	gradually, by degrees
竹子	zhúzi	bamboo
主辦	zhǔbàn	direct, sponsor, host
主持	zhǔchí	take charge/care of, manage, direct, uphold, stand for
主動	zhǔdòng	on one's own initiative
主婦	zhǔfù	housewife, hostess
主觀	zhǔguān	subjective
主管	zhǔguǎn	person in charge
主題	zhǔtí	theme, subject, motif, leitmotiv
主席	zhǔxí	chairof meeting, chair/presidentof organization/state
主要	zhǔyào	mainly, essentially
主張	zhǔzhāng	view, position, stand, proposition
主張	zhǔzhāng	advocate, stand for, maintain, hold
註冊	zhùcè	register
祝福	zhùfú	new year's sacrificein part of Zhejiang
祝福	zhùfú	invoke blessing, wish happiness to
祝賀	zhùhè	congratulate
助理	zhùlǐ	assistant
著名	zhùmíng	famous, celebrated
注射	zhùshè	inject
住院	zhùyuàn	be hospitalized
住宅	zhùzhái	residence, dwelling
住址	zhùzhǐ	address
專家	zhuānjiā	expert, specialist
專利	zhuānlì	patent
專門	zhuānmén	professional
專門	zhuānmén	special, specialized
專人	zhuānrén	person specially assigned for a task/job
專心	zhuānxīn	be absorbed in, concentrate effort
專業	zhuānyè	special field of research, specialty, discipline
專業	zhuānyè	professional
轉變	zhuǎnbiàn	change, transform
轉播	zhuǎnbò	relayradio/TV broadcast
轉達	zhuǎndá	pass on, convey, communicate
轉告	zhuǎngào	transmit message, communicate, pass on word
轉機	zhuǎnjī	change planes
轉身	zhuǎnshēn	face about, turn round
轉向	zhuǎnxiàng	change direction, change political/etc. stand
裝飾	zhuāngshì	decorate, adorn, ornament, deck
狀況	zhuàngkuàng	condition/stateof affairs
狀態	zhuàngtài	stateof affairs, condition
追求	zhuīqiú	seek, pursue, woo, court
準確	zhǔnquè	accurate, exact, precise
準時	zhǔnshí	punctually
資本	zīběn	capital, sth. capitalized on
資格	zīgé	qualifications, seniority
資金	zījīn	fund
資源	zīyuán	natural resources
子女	zǐnǚ	sons and daughters, children
仔細	zǐxì	be careful
自從	zìcóng	since
自動	zìdòng	automatic
字母	zìmǔ	letter of an alphabet, letter
字幕	zìmù	caption, subtitle
自然	zìrán	natural, free from affectation
自然	zìrán	nature, natural world
自私	zìsī	selfish, self-centered
自殺	zìshā	commit suicide
自我	zìwǒ	self, oneself
自信	zìxìn	be self-confident
自願	zìyuàn	act voluntarily
自在	zìzài	free, unrestrained
自主	zìzhǔ	be one's own master, take initiative
宗教	zōngjiào	religion
總共	zǒnggòng	in all, altogether
總理	zǒnglǐ	premier, prime minister
總算	zǒngsuàn	at long last, finally
總之	zǒngzhī	in a word, in short
綜合	zònghé	synthetical, comprehensive, multiple, composite
綜合	zònghé	synthesize
走道	zǒudào	sidewalk
走私	zǒusī	smuggle
走走	zǒuzǒu	1go for a stroll; 2come or go in a general sense
足以	zúyǐ	sufficient/enough to
阻礙	zǔ'ài	hinder, block, impede, bar
祖父	zǔfù	paternal grandfather
祖國	zǔguó	homeland, native land
祖母	zǔmǔ	paternalgrandmother
祖先	zǔxiān	ancestors, forebears
組織	zǔzhī	1 organization, organized system; 2 tissue, nerve
阻止	zǔzhǐ	prevent, stop, prohibit
最初	zuìchū	initially, at first
最多	zuìduō	at the most
最佳	zuìjiā	optimum, best, first-rate
最少	zuìshǎo	at least
尊敬	zūnjìng	respect, honor, esteem
遵守	zūnshǒu	observe, abide by
尊重	zūnzhòng	respect, value, esteem
左右	zuǒyòu	left and right
左右	zuǒyòu	nearby, not far away
作家	zuòjiā	writer
做客	zuòkè	stay, be a guest
做夢	zuòmèng	dream
作品	zuòpǐn	works of literature/art
做人	zuòrén	conduct oneself, behave, be an upright person
作為	zuòwéi	regard as, look on as, take for
座位	zuòwèi	seat, place
作文	zuòwén	write an essay, a composition, an article, to compose
作文	zuòwén	composition
作用	zuòyòng	action, function, effect, intention, motive
作者	zuòzhě	author, writer
比方說	bǐfāngshuō	for instance
比如說	bǐrúshuō	for instance
冰淇淋	bīngqílín	ice cream
博物館	bówùguǎn	museum
不見得	bújiàndé	not necessarily/likely
不用說	búyòngshuō	it goes without saying; needless to say; as a matter of course
不得不	bùdébù	cannot but, have to
不得已	bùdéyǐ	have no alternative
不敢當	bùgǎndāng	not be deserving of
不由得	bùyóude	can't help
長方形	chángfāngxíng	rectangle
打招呼	dǎzhāohū	say hello, greet sb.
大多數	dàduōshù	most of, the majority of
大哥大	dàgēdà	portable/cellular telephone
大清早	dàqīngzǎo	very early morning
大自然	dàzìrán	nature
蛋白質	dànbáizhí	protein
等不及	děngbùjí	be too late to wait
電視台	diànshìtái	TV station
動不動	dòngbúdòng	easily, at the slightest provocation, frequently, at every turn
多半兒	duōbàner	probably, most likely
發脾氣	fāpíqì	lose temper, get angry
飯館兒	fànguǎner	restaurant
感興趣	gǎnxìngqù	be interested in
幹什麼	gànshéme	why
掛號信	guàhàoxìn	registered letter/mail
過日子	guòrìzi	live, get along, practice economy
還不如	háibùrú	it would be better to
好意思	hǎoyìsi	have the nerve
合不來	hébùlái	not get along well
合得來	hédelái	get along well
恨不得	hènbùdé	very anxious to, itch to
化妝品	huàzhuāngpǐn	cosmetics
基本上	jīběnshàng	basically
基督教	jīdūjiào	Christianity
加油站	jiāyóuzhàn	gas station
獎學金	jiǎngxuéjīn	scholarship
進一步	jìnyíbù	go step further
就是說	jiùshìshuō	that is to say, in other words, namely
俱樂部	jùlèbù	socialclub
看不起	kànbùqǐ	scorn, despise
看得起		kàndeqǐ	think highly of
看起來	kànqǐlái	it seems, it looks as if
看樣子	kànyàngzi	it looks as if, it appears, it seems
口袋兒	kǒudàier	pocket
拉肚子	lādùzi	suffer from diarrhoea, have diarrhea, have loose bowels
來不及	láibùjí	be too late to do sth.
來得及	láidejí	there's still time to do sth., be in time
老百姓	lǎobǎixìng	common people, civilians
老闆娘	lǎobǎnniáng	boss wife
老實說	lǎoshíshuō	honestly
老太太	lǎotàitai	old lady, yourmy/his/etc.mother
聯合國	liánhéguó	United Nations
連續劇	liánxùjù	TV series
了不起	liǎobùqǐ	amazing, terrific, extraordinary, marvelous
零用錢	língyòngqián	pocket money
留學生	liúxuéshēng	student studying abroad, returned student
旅行社	lǚxíngshè	a travel/tourist agency
沒辦法	méibànfǎ	can do nothing about it, can't help it
沒法子	méifázi	[informal]can do nothing about it, can't help it, helpless
沒想到	méixiǎngdào	unexpected
目的地	mùdìdì	destination
牛仔褲	niúzǐkù	jean
農產品	nóngchǎnpǐn	agricultural products, farm produce
普通話	pǔtōnghuà	putonghua, Mandarin Chinese, common speech, standard language
青少年	qīngshàonián	young people and teenagers, youths
人行道	rénxíngdào	sidewalk
忍不住	rěnbúzhù	can't bear, can't help but do something
日用品	rìyòngpǐn	articles for daily use
如果說	rúguǒshuō	[informal]if, in case
三角形	sānjiǎoxíng	triangle
三明治	sānmíngzhì	sandwich
曬太陽	shàitàiyáng	sunbathe, bask, sun
傷腦筋	shāngnǎojīn	troublesome, bothersome, knotty
捨不得	shěbùdé	hate to use or part with, grudge, begrudge
事實上	shìshíshàng	as a matter of fact, factually
收音機	shōuyīnjī	radio set
手電筒	shǒudiàntǒng	torch
受不了	shòubùliǎo	be unable to endure
受得了	shòudeliǎo	stand up to
說不定	shuōbúdìng	perhaps, maybe
說起來	shuōqǐlái	now that it is mentioned, in regard to
俗話說	súhuàshuō	As the old saying goes …
算起來	suànqǐlái	all considered
天主教	tiānzhǔjiào	Catholicism
聽起來	tīngqǐlái	it sounds like
托兒所	tuōérsuǒ	nursery, child-care center
維他命	wéitāmìng	vitamin
衛生紙	wèishēngzhǐ	toilet paper
無所謂	wúsuǒwèi	be indifferent, not matter
洗衣粉	xǐyīfěn	washing powder for clothes, laundry detergent
下午茶	xiàwǔchá	teatime
嚇一跳	xiàyítiào	startle, start
想不到	xiǎngbúdào	unable to anticipate
相片兒	xiàngpiàner	photograph, photo
消費者	xiāofèizhě	consumer
心目中	xīnmùzhōng	mood, frame of mind, memory, mind, mental view
要不然	yàobùrán	otherwise, or else, or
要不是	yàobúshì	if it were not for, but for
一大早	yídàzǎo	
一陣子	yízhènzi	a burst, a fit, a peal
一方面	yìfāngmiàn	one aspect only, on the one hand
一口氣	yìkǒuqì	at a heat, at one blast, at a whack, holus-bolus
用不著	yòngbùzháo	not need, have no use for
用得著	yòngdezháo	
原則上	yuánzéshàng	basically, in principle
原子筆	yuánzǐbǐ	ball-point pen
占/佔	zhàn	occupy, take
占/佔	zhàn	constitute, make up, account for
這下子	zhèxiàzi	at present
這樣子	zhèyàngzi	such, so,
這樣子	zhèyàngzi	like this
這陣子	zhèzhènzi	these days, lately, recently
正方形	zhèngfāngxíng	square
殖民地	zhímíndì	colony
周/週	zhōu	measure word for times of going around something, such as earth, islands, etc.
自來水	zìláishuǐ	running/tap water
自行車	zìxíngchē	bicycle, bike
白（白）	báibái	in vain, without results
保證/証	bǎozhèng	guarantee
保證/証	bǎozhèng	guarantee
布/佈告	bùgào	notice, bulletin
布/佈置	bùzhì	arrange, fix up, assign
嘗/嚐試	chángshì	try
嘗/嚐試	chángshì	attempt, try
潮溼/濕	cháoshī	moist, damp
成分/份	chéngfèn	composition, component part, ingredient, class/economic status
吃喝玩樂	chīhēwánlè	idle away one's time in pleasure-seeking ,eat
充分/份	chōngfèn	full, ample, abundant
蟲（子）	chóngzi	worm, insect
抽煙/菸	chōuyān	smokepipe/etc.
多多少少	duōduōshǎoshǎo	somewhat, to some extent, more or less
分布/佈	fēnbù	be distributedover an area, be scattered
份（兒）	fèner	share, portion
各行各業	gèhánggèyè	all professions/trades
各式各樣	gèshìgèyàng	all sorts/kinds, various
公布/佈	gōngbù	promulgate, announce, publish
公用電話	gōngyòngdiànhuà	pay phone
規畫/劃	guīhuà	plan, program
規畫/劃	guīhuà	program, plan
櫃臺/台	guìtái	counter
鍋（子）	guōzi	a cooking-pot, saucepan
過分/份	guòfèn	excessive, undue
話說回來	huàshuōhuílái	but then again
或多或少	huòduōhuòshǎo	somewhat, to some extent
絕大部分	juédàbùfèn	most of, the majority of
空（兒）	kònger	a cleft, fissure, a blank, unoccupied space or time
梨（子）	lízi	pear
裡/裏頭	lǐtou	inside, interior
秘/祕密	mìmì	secret
秘/祕書	mìshū	secretary
偏（偏）	piānpiān	just, but, only
人情味兒	rénqíngwèier	human touch/interest
上台/臺	shàngtái	mount platform, appear on the stage
身分/份	shēnfèn	identity, status, capacity
水分/份	shuǐfèn	moisture content
四周/週	sìzhōu	all around, on all sides, on every side
偷（偷）	tōutōu	stealthily, secretly
味（兒）	wèier	1taste, flavour2smell, odour3delicacies or foods
無可奈何	wúkěnàihé	have no alternative
無論如何	wúlùnrúhé	in any case, at any rate, no matter what
舞台/臺	wǔtái	stage, arena
蝦（子）	xiāzi	shrimp
相親相愛	xiāngqīnxiāngài	intimate, fond of each other
消/宵夜	xiāoyè	midnight snack
宣布/佈	xuānbù	declare, proclaim, announce
鴨（子）	yāzi	duck
一般而言	yìbānéryán	in general, generally speaking
一般來說	yìbānláishuō	in general, generally speaking
一天到晚	yìtiāndàowǎn	all day long
占/佔有	zhànyǒu	own, have, occupy, hold
總而言之	zǒngéryánzhī	in short, in a word
做/作法	zuòfǎ	way of doing or making a thing, method of work, practice
布/佈告欄	bùgàolán	bulletin board
茶館（兒）	cháguǎner	teahouse
待會（兒）	dàihuǐer	shortly, in a little while
農民/農夫	nóngmín/nóngfū peasant,	peasantry	
身分/份證	shēnfènzhèng	identity/identification card
手指（頭）	shǒuzhǐtou	finger
准考證/証	zhǔnkǎozhèng	admission ticket
