阿姨	āyí	one's mother's sister, auntie; address to woman of similar age as parents
安全	ānquán	to be safe, secure
辦法	bànfǎ	method, way of doing something
幫忙	bāngmáng	to help someone do something
必須	bìxū	must
邊兒	biānér	side
別人	biérén	other people
餅乾	bǐnggān	biscuit, cracker, cookie
冰箱	bīngxiāng	refrigerator
病人	bìngrén	patient
不錯	búcuò	to be not bad, pretty good
不但	búdàn	not only
不用	búyòng	need not, don't have to
菜單	càidān	menu
餐桌	cānzhuō	dining table
草地	cǎodì	lawn
叉子	chāzi	fork
城市	chéngshì	city
襯衫	chènshān	a dress shirt or a collared blouse with buttons
遲到	chídào	to be late/ arrive late
窗戶	chuānghù	window
聰明	cōngmíng	to be intelligent
從前	cóngqián	formerly, in the past, used to
袋子	dàizi	bag, sack
但是	dànshì	but, still, however
刀子	dāozi	knife
打掃	dǎsǎo	to sweep, to clean
打算	dǎsuàn	to plan
大聲	dàshēng	to be loud
大衣	dàyī	overcoat, topcoat
德國	déguó	Germany, German
電燈	diàndēng	electric lamp/ light
點兒	diǎn	ér
點菜	diǎncài	to order food
點心	diǎnxīn	a snack, light refreshment
動物	dòngwù	animal
讀書	dúshū	to study, to read
耳朵	ěrduō	ear
法國	fǎguó	France, French
飯店	fàndiàn	hotel, restaurant
方法	fāngfǎ	method, way, means
放假	fàngjià	holiday
放下	fàngxià	to lay down; to put down; to let sth down; to lower; to set down
發生	fāshēng	to happen, to occur, take place
發現	fāxiàn	to discover
父親	fùqīn	father
剛剛	gānggāng	just now
恭喜	gōngxǐ	to congratulate
工作	gōngzuò	to work
關上	guānshàng	to close, to shut; to turn off
果汁	guǒzhī	fruit juice
過來	guòlái	to come over/ up, come here
過年	guònián	to celebrate the Chinese New Year
過去	guòqù	in the past, formerly
過去	guòqù	to go over, to pass by
故事	gùshì	story
害怕	hàipà	be afraid/  scared
漢堡	hànbǎo	hamburger
韓國	hánguó	the Republic of Korea
漢語	hànyǔ	Chinese/ Sinitic languages
漢字	hànzì	Ch character, sinograph
好看	hǎokàn	to be good-looking
盒子	hézi	box
黑色	hēisè	black
紅包	hóngbāo	red envelope containing a money gift
紅茶	hóngchá	black tea
後來	hòulái	afterwards, later on
護士	hùshì	hospital nurse
畫家	huàjiā	a painteras in an artist
花園	huāyuán	flower garden
滑雪	huáxuě	to ski
回答	huídá	to answer
或是	huòshì	or, perhaps
機會	jīhuì	chance, opportunity
計畫	jìhuà	plan, project, program
家庭	jiātíng	family, household
簡單	jiǎndān	to be simple, uncomplicated
講話	jiǎnghuà	to speak, talk, address
餃子	jiǎozi	Chinese dumpling
結婚	jiéhūn	to marry, to get married
節目	jiémù	program, eventsof entertainment, a program, etc.
解決	jiějué	to resolve, settle
經過	jīngguò	to pass by, to pass through
警察	jǐngchá	police officer
緊張	jǐnzhāng	to be nervous, to be tense
就要	jiùyào	soon, in no time
決定	juédìng	to decide
句子	jùzi	sentence
開始	kāishǐ	to start
開水	kāishuǐ	boiling/ boiled water
開心	kāixīn	to feel happy, rejoice
開學	kāixué	to start school, to begin term
看到	kàndào	to see
看見	kànjiàn	to see
科學	kēxué	science
可愛	kěài	to be lovable, likeable, adorable, cute
課本	kèběn	textbook
客氣	kèqì	to be polite
客人	kèrén	guest, visitor
課文	kèwén	text in a school book
空氣	kōngqì	air
筷子	kuàizi	chopsticks
藍色	lánsè	blue
老人	lǎorén	old man/ woman
禮物	lǐwù	present, gift
練習	liànxí	to practice, to drill
涼快	liángkuài	to bepleasantlycool
旅遊	lǚyóu	to travel
路上	lùshàng	on the road
麻煩	máfán	an on annoyance, troublesome
麻煩	máfán	to be annoyed; to bother
馬上	mǎshàng	immediately
毛衣	máoyī	sweater
帽子	màozi	hat, cap, headgear
美麗	měilì	to be beautiful
木頭	mùtóu	wood, log, timber
那邊	nàbiān	there, over there
奶奶	nǎinai	grandma, grandmotherfather's mother
難過	nánguò	to be sad, to be distressed
年紀	niánjì	age
年輕	niánqīng	to be young
鳥兒	niǎoér	bird
努力	nǔlì	to make great effort, try hard
暖和	nuǎnhuo	to be warm
爬山	páshān	to climb a mountain, to hike on hills
盤子	pánzi	plate
蘋果	píngguǒ	apple
瓶子	píngzi	bottle
奇怪	qíguài	to be strange, to be queer, to be unusual
汽水	qìshuǐ	soda pop, carbonated drink
起來	qǐlái	to stand up, to rise
汽車	qìchē	automobile, car
鉛筆	qiānbǐ	pencil
前天	qiántiān	the day before yesterday
清楚	qīngchǔ	to be clear
晴天	qíngtiān	clear day, sunny day
請客	qǐngkè	to host, to invite, to treat someoneto dinner, etc.
慶祝	qìngzhù	to celebrate
全部	quánbù	all, whole
裙子	qúnzi	skirt
然後	ránhòu	afterwards, then
認為	rènwéi	to believe that, consider that
認真	rènzhēn	to be conscientious, earnest, serious
日子	rìzi	days
如果	rúguǒ	if, in case, in the event of
森林	sēnlín	forest
沙發	shāfā	sofa
上來	shànglái	to come up; up
上去	shàngqù	to go up
上學	shàngxué	to attend school, to be at school
生活	shēnghuó	life
生活	shēnghuó	to live
生氣	shēngqì	to be angry; to take offense
聲音	shēngyīn	sound, voice
市場	shìchǎng	market
世界	shìjiè	the world
事情	shìqíng	affair; something to do, a matter, event
石頭	shítóu	stone
食物	shíwù	food, edibles
手套	shǒutào	gloves, mittens
書桌	shūzhuō	desk
刷牙	shuāyá	to brush ones teeth
雖然	suīrán	though, although
隨便	suíbiàn	whatever, wherever, whenever, do as one please
所有	suǒyǒu	all
湯匙	tāngchí	soup spoon
討厭	tǎoyàn	to dislike, to loathe, to hate
天天	tiāntiān	every day, daily
聽見	tīngjiàn	to hear
聽說	tīngshuō	hear it said
停車	tíngchē	to park the car
通知	tōngzhī	information
通知	tōngzhī	to inform, to notify
頭髮	tóufǎ	hairon the human head
外套	wàitào	overcoat
危險	wéixiǎn	to be dangerous, perilous
味道	wèidào	taste, flavor, smell, odor
無聊	wúliáo	to be bored; to be boring and uninteresting; to be a nuisance; to be nonsensical
西瓜	xīguā	watermelon
希望	xīwàng	to hope, to wish
習慣	xíguàn	habit
需要	xūyào	to need, to demand
許多	xǔduō	many, a lot of
下來	xiàlái	to come down from a higher place
下去	xiàqù	to go down; descend
下雪	xiàxuě	to snow
鄉下	xiāngxià	countryside
相信	xiāngxìn	to trust
箱子	xiāngzi	box, trunk, case
消息	xiāoxí	news, information
小說	xiǎoshuō	novel, short story
小偷	xiǎotōu	thief, burglar
小學	xiǎoxué	elementary school
笑話	xiàohuà	joke
校長	xiàozhǎng	principal/ head of a school, head-master
辛苦	xīnkǔ	to be hard, toilsome, painstaking
新聞	xīnwén	news
星星	xīngxīng	stars
興趣	xìngqù	interest
學習	xuéxí	to study; to learn
牙刷	yáshuā	toothbrush
顏色	yánsè	color
眼鏡	yǎnjìng	glasses, spectacles
鑰匙	yàoshí	key
要是	yàoshì	if
樣子	yàngzi	appearance
也許	yěxǔ	perhaps, maybe, might
爺爺	yéye	granpa
一邊	yìbiān	at the same time, simultaneously; on the one/ other hand
飲料	yǐnliào	soft drink, beverage
陰天	yīntiān	overcast sky, cloudy day
應該	yīnggāi	should, ought to
永遠	yǒngyuǎn	always, forever
有趣	yǒuqù	interesting, fascinating, amusing
有用	yǒuyòng	to be useful
原來	yuánlái	originally, formerly
院子	yuànzi	yard
願意	yuànyì	to be willing
月亮	yuèliàng	moon
語法	yǔfǎ	grammar
語言	yǔyán	language
炸雞	zhájī	fried chicken
著急	zhāojí	to be nervous, anxious
這邊	zhèbiān	this side, here
正在	zhèngzài	indicating an action in progress
只好	zhǐhǎo	cannot but, have to
中間	zhōngjiān	between, among, in the middle of
鐘頭	zhōngtóu	hour
中心	zhōngxīn	center, heart, central point
準備	zhǔnbèi	to prepare, to intend
注意	zhùyì	to pay attention to, to take notice of
總是	zǒngshì	always, without exception
嘴巴	zuǐbā	mouth
做菜	zuòcài	to cook
作業	zuòyè	homework
不一定	bùyīdìng	uncertain, not for sure, not necessarily
動物園	dòngwùyuán	zoo
服務生	fúwùshēng	attendant, service person, waiter
紅綠燈	hónglǜdēng	traffic light
計程車	jìchéngchē	taxi
裡邊兒	lǐbiānér	inside
聊天兒	liáotiānér	chat
那麼樣	nàmeyàng	in that case
旁邊兒	pángbiānér	beside
巧克力	qiǎokèlì	chocolate
一半兒	yíbànér	half
一會兒	yíhuìér	a moment, a short while
越來越	yuèláiyuè	more and more…
這麼樣	zhèmeyàng	like this
計畫/劃	jìhuà/huà	to	plan, to map out
摩托車/機車	mótuōchē/jīchē motorcycle,	motor	scooter
超級市場/超市	chāojíshìchǎng/chāoshì	supermarket
