安排	ānpái	arrangement
安排	ānpái	to arrange, to plan, to fix up, to provide
安全	ānquán	safety, security
巴士	bāshì	bus
白菜	báicài	Chinese cabbage
白天	báitiān	daytime, day
搬家	bānjiā	to move one's house
半天	bàntiān	half a day, a very long time
幫助	bāngzhù	to help, to assist
抱歉	bàoqiàn	be sorry/ apologetic
本來	běnlái	originally
鼻子	bí	zinose
比較	bǐjiào	to compare
畢業	bìyè	to graduate from a school
變成	biànchéng	to change into
變化	biànhuà	change, transformation
變化	biànhuà	to change, vary
表現	biǎoxiàn	manifestation, expression
表現	biǎoxiàn	to show, to display, to exhibit, to represent, to express, to manifest
表演	biǎoyǎn	performance
表演	biǎoyǎn	to perform, act, play, demonstrate
不過	búguò	but, however
不要	búyào	don't want, don'tdo sth
不必	búbì	need not, not have to
不可	bùkě	cannot, should not, must not
不少	bùshǎo	not few, many
不少	bùshǎo	a lot of
部分	bùfèn	part, section
不管	bùguǎn	no matter, regardless of
不見	bújiàn	to be disappear, to be lost
不久	bùjiǔ	not long after
不同	bùtóng	to be different
不行	bùxíng	to be not permitted
參觀	cānguān	to visit a place, exhibition, etc.
草原	cǎoyuán	grasslands, prairie
產品	chǎnpǐn	product
程度	chéngdù	degree, level, extent
成功	chénggōng	to be succeed
誠實	chéngshí	to be honest
出發	chūfā	to set out, to start off, to start/ proceed from
出現	chūxiàn	to appear, to arise, to emerge
除了	chúle	besides, except for
春節	chūnjié	the Chinese New Year
從來	cónglái	all along, at all times, always
錯誤	cuòwù	mistake
答應	dāyìng	to answer, to reply
大概	dàgài	probably
大陸	dàlù	mainland, continent, Mainland China ainland China
大人	dàrén	adult
代表	dàibiǎo	representative, delegate
代表	dàibiǎo	to represent, to stand for
擔心	dānxīn	to worry, feel anxious
當中	dāngzhōng	among
到處	dàochù	everywhere
到底	dàodǐ	to the end, at last, after all
道理	dàolǐ	reason, rationality, the right way
得到	dédào	to be succeed in obtaining, to gain, to receive
得很	dehěn	very, quite, awfully
的話	dehuà	if
底下	dǐxià	under, below, beneath
地區	dìqū	area, district, region
地下	dìxià	underground
地址	dìzhǐ	address
點兒	diǎnéra	bit
電車	diànchē	tram, tramcar, streetc.ar, trolleybus, trolley
對方	duìfāng	other side/ party
多少	duōshǎo	somewhat; to some extent
多麼	duóme	how good, beautiful, etc..; what
兒童	értóng	children
發票	fāpiào	invoice
發燒	fāshāo	to be under an attack of fever
發現	fāxiàn	discovery
方面	fāngmiàn	aspect, side, facet
方式	fāngshì	way, fashion, pattern
方向	fāngxiàng	direction, orientation
房東	fángdōng	a landlord or landlady, a lessor
房租	fángzū	rent
放心	fàngxīn	to be at ease, not worry
訪問	fǎngwèn	to visit, to call on, to interview
費用	fèiyòng	cost, expenses
豐富	fēngfù	to be rich, abundant, plentiful
服務	fúwù	be in the service of, to serve
複習	fùxí	to reviewa lesson, etc.
負責	fùzé	to be responsible for, to be in charge of
改變	gǎibiàn	change
改變	gǎibiàn	to change, to alter, to ransform
感覺	gǎnjué	sense, perception, feeling
感覺	gǎnjué	to feel, to perceive, to become aware of
趕快	gǎnkuài	quickly, hastily
感謝	gǎnxiè	to thank, to be grateful
剛才	gāngcái	just now
歌兒	gēérsong	
個人	gèrén	individual person
各位	gèwèi	everyone
公分	gōngfēn	centimeter
公尺	gōngchǐ	meter
公共	gōnggòng	public, common, communal
公斤	gōngjīn	kilogram
公克	gōngkè	gram
公里	gōnglǐ	kilometer
公路	gōnglù	highway, road
工人	gōngrén	worker
關係	guānxì	relationship
關心	guānxīn	to be concerned about
廣播	guǎngbò	broadcasting
廣播	guǎngbò	to broadcast
貴姓	guìxìng	What's your last name?
還是	háishì	still, nevertheless
海洋	hǎiyáng	ocean, sea
好處	hǎochù	good, benefit, advantage, gain, profit
好幾	hǎojǐ	quite a few
好久	hǎojiǔ	for a long time
好了	hǎole	elucidating a previous proposition so as to diminish its effect
好聽	hǎotīng	to be pleasant to listen to, pleasing to the ear, nice sounding
好些	hǎoxiē	quite a lot, a lot of
合作	hézuò	to cooperate, to collaborate, to work together
黑板	hēibǎn	blackboard
後天	hòutiān	day after tomorrow
環境	huánjìng	environment, surroundings, circumstances
回答	huídá	answer, reply
回國	huíguó	to return to one's country
會話	huìhuà	conversationas in language course
會議	huìyì	meeting, conference
活動	huódòng	to exercise, to move about
忽然	hūrán	suddenly
互相	hùxiāng	mutually, each other
護照	hùzhào	passport
雞蛋	jīdàn	hen's egg
機器	jīqi	machine
繼續	jìxù	to continue, to go on
季節	jì	jié season
家具	jiājù	furniture, house furnishings, fittings
檢查	jiǎnchá	to check, to inspect, to examine
健康	jiànkāng	healthy
建設	jiànshè	construction
建設	jiànshè	to build, to construct
將來	jiānglái	future
醬油	jiàngyóu	soy sauce
郊區	jiāoqū	suburban district, outskirts
教書	jiāoshū	to teach in school; to teachusu for a living
教育	jiàoyù	education
教育	jiàoyù	educate, teach, inculcate
叫做	jiàozuò	be called, be known as
接受	jiēshòu	to accept, receivehonorsetc.
接著	jiēzhe	and then, after that
節日	jiérì	festival, holiday
結果	jiéguǒ	in the event, so that, so…that
姊妹	jiěmèi	sisters
解釋	jiěshì	explanation, interpretation
解釋	jiěshì	to explain, to interpret, to analyze
極了	jíle	extremely, very
進行	jìnxíng	to proceed; to carry sth out
金子	jīnzi	metals, gold, money
經常	jīngcháng	often, frequently, regularly, constantly
經過	jīngguò	as a result of, after, through
精神	jīngshén	spirit, vigor, drive
舉行	jǔxíng	to holdmeeting/etc.
橘子	júzi	tangerine
決定	juédìng	decision, resolution
卡車	kǎchē	truck, lorry
開花	kāihuā	to flower, to bloom, to blossom
開會	kāihuì	to hold a meeting, to hold a council
開始	kāishǐ	since
看病	kànbìng	to see a doctor; to see a patient
看法	kànfǎ	way of looking at sth, view
科學	kēxué	scientific
咳嗽	késòu	to cough
可能	kěnéng	possibility
可以	kěyǐ	passable, pretty good, not bad
空間	kōngjiān	space, room
口袋	kǒudài	a pocket
快要	kuàiyào	soon, in no time
困難	kùnnán	difficulty
困難	kùnnán	to be difficult
裡面	lǐ	miàninside
禮拜	lǐbài	week
立刻	lìkè	immediately, at once
例如	lìrú	for instance/ example, eg, such as
利用	lìyòng	to use, to take advantage of, to pexploit
練習	liànxí	practice, exercise
了解	liǎojiě	to understand, to comprehend
零錢	língqián	small change, small money
鄰居	línjū	neighbor
樓梯	lóutī	stairs
旅館	lǚguǎn	hotel
錄音	lùyīn	to make an audio recording
馬路	mǎlù	a street used by vehicular traffic, a road
滿意	mǎnyì	to be satisfied, to be pleased
慢用	mànyòng	eat slowlyenjoy your meal
毛病	máobìng	trouble, illness, problem
沒錯	méicuò	I' m quite sure
沒用	méiyòng	useless
米飯	mǐfàn	cooked rice
麵條	miàntiáo	noodle
明白	míngbái	to understand, to know, to realize
名詞	míngcí	noun
母親	mǔqīn	mother
目的	mùdì	purpose, aim, goal, objective, end
目前	mùqián	at present, at the moment
哪些	nǎxiē	which
那麼	nàme	like that, in that way
那樣	nàyàng	such, so, in that case
奶茶	nǎichá	tea with milk
難看	nánkàn	ugly
男人	nánrén	man
內容	nèiróng	content, substance
能夠	nénggòu	can, would, may
能力	nénglì	ability, capability, might
年底	niándǐ	end of year
年級	niánjí	grade, yearin school, etc.
年年	niánnián	every year
念書	niànshū	to read, to study
牛肉	niúròu	beef
女人	nǚrén	woman
啤酒	píjiǔ	beer
平安	píngān	to be safe and sound
平常	píngcháng	in ordinary/normal times, ordinarily, usually
葡萄	pútáo	grape
前年	qiánnián	year before last
青菜	qīngcài	green vegetables, greens
青年	qīngnián	youth, young people
情況	qíngkuàng	circumstances, situation
情形	qíngxíng	circumstances, situation
請假	qǐngjià	to ask for leave
其中	qízhōng	amongwhich, them, etc.
全身	quánshēn	whole body
熱水	rèshuǐ	hot water
人家	rénjiā	1a pronoun for sb else, I (used by females); 2 dwelling, household, family, sb else's house
人口	rénkǒu	population
人們	rénmen	people
人民	rénmín	the people, citizen
認得	rèndé	to knowas in to recognize
任何	rènhé	any
日記	rìjì	diary
日期	rìqí	date
散步	sànbù	to take a walk
上街	shàngjiē	to go into the street, to go shopping
身上	shēnshàng	on one's body
聲調	shēngdiào	tone, note
生意	shēngyì	business, trade
生字	shēngzì	unfamiliar word, new wordin pedagogy
時代	shídài	times, era, epoch, period in one's life
十分	shífēn	completely, very, fully, utterly, extremely
石油	shíyóu	petroleum, oil
使用	shǐyòng	to use; to put to use; to make use of
事實	shìshí	fact
數學	shùxué	mathematics
水餃	shuǐjiǎo	boiled dumpling
書架	shūjià	bookshelf, bookcase
說明	shuōmíng	explanation, illustration, show
說明	shuōmíng	to explain, to illustrate, to show
隨時	suíshí	at any time, at all times, whenever necessary, as occasion demands
它們	tāmen	they
颱風	táifēng	typhoon
態度	tàidù	manner, attitude
太陽	tàiyáng	the sun
討論	tǎolùn	discussion
討論	tǎolùn	to discuss, to take something up with someone, to talk about
提高	tígāo	to lift, to raise, to heighten, to enhance, to increase, to improve, to advance
提供	tígōng	to provide; to supply; to put sth up
體育	tǐyù	physical education/ training, sports
聽到	tīngdào	to hear
通過	tōngguò	to pass through; to come through; to get across
痛苦	tòngkǔ	be painful
同時	tóngshí	simultaneously; in the meantime; in the meanwhile; at the same time; at one time; in chorus
同樣	tóngyàng	equally
同樣	tóngyàng	to be same, to be equal, to be similar
同意	tóngyì	to agree, to consent, to approve
土地	tǔdì	ground, soil, acres, land
襪子	wàzi	socks, stockings, hose
外面	wàimiànoutside,	excluding	
外邊	wàibiān	outside, exterior
外國	wàiguó	foreign country
外文	wàiwén	foreign language
外語	wàiyǔ	foreign language
完成	wánchéng	to accomplish, to complete, to fulfill
完全	wánquán	completely, fully, wholly, absolutely
晚會	wǎnhuì	evening entertainment/ party
忘記	wàngjì	to forget
未來	wèilái	future
位子	wèizi	seat, place
文化	wénhuà	culture, civilization, education, literacy
文學	wénxué	literature
文章	wénzhāng	essay, article, literary works, writings
文字	wénzì	characters, script, writing, written language, writing style/ phraseology
握手	wòshǒu	to shakeor clasp  hands
屋子	wūzi	room; house
希望	xīwàng	hope, wish
西餐	xīcān	Western-style food
習慣	xíguàn	to be accustomed/ used to
下來	xiàlái	[aspect]
現代	xiàndài	modern times, contemporary age
想法	xiǎngfǎ	idea
心情	xīnqíng	mood, frame/ state of mind
信箱	xìnxiāng	letter box, mailbox, post-office box
信心	xìnxīn	confidence, faith
姓名	xìngmíng	full name
兄弟	xiōngdì	brothers
需要	xūyào	need, want, require, demand
選擇	xuǎnzé	a choice, selection, option
選擇	xuǎnzé	to choose, to select
學費	xuéfèi	school tuition fees
學期	xuéqí	school term, semester
牙齒	yáchǐ	tooth
研究	yánjiù	study, research
研究	yánjiù	to study, to research
嚴重	yánzhòng	serious, grave, critical
陽光	yángguāng	sunlight, sunshine
樣樣	yàngyàng	every kind, everything, each and every, all
要求	yāoqiú	request, demand
要求	yāoqiú	to askfor, to request, to demand
要緊	yàojǐn	important, essential, critical, serious
一切	yíqiè	everything
一下	yíxià	a little, a while
一樣	yíyàng	same
以為	yǐwéi	to think, to assumeincorrectly
意見	yìjiàn	idea, view, opinion, suggestion
影響	yǐngxiǎng	influence
影響	yǐngxiǎng	to influence, to affect
用功	yònggōng	to be studious, industrious, to be hard-working
尤其	yóuqí	especially
有的	yǒude	some
有空	yǒukòng	to have time to do sth
有名	yǒumíng	to be well-known, famous
有錢	yǒuqián	to be rich/ wealthy
右手	yòushǒu	right hand
雨傘	yǔsǎn	umbrella
玉米	yùmǐ	maize, Indian
預習	yùxí	to prepare lessons before class
原諒	yuánliàng	to excuse, to forgive, to pardon
原因	yuányīn	cause, reason
預備	yùbèi	1to prepare; 2to get ready
遇到	yùdào	to run into, encounter, meet
早安	zǎoān	good morning
早晚	zǎowǎn	morning and evening, early or late
怎樣	zěnyàng	how?
增加	zēngjiā	to increase; to raise; to add; to step up
長大	zhǎngdà	to grow up
找錢	zhǎoqián	to give change to someone after a purchase
照顧	zhàogù	to look after, to care for
這樣	zhèyàng	such, this kind
整齊	zhěngqí	to be in good order, neat, tidy
真正	zhēnzhèng	really, truly
真正	zhēnzhèng	to be genuine, to be true, to be real
正常	zhèngcháng	to be normal, regular
正確	zhèngquè	to be correct, to be right, to be proper
值得	zhídé	to be worthwhile, worthdoing something
只要	zhǐyào	so long as, provided
只有	zhǐyǒu	can only, have no choice but, to be forced to
中餐	zhōngcān	Chinese meal/  food; lunch
中飯	zhōngfàn	midday meal, lunch
中學	zhōngxué	middle school
主人	zhǔrén	master, host, owner
主任	zhǔrèn	director, head, chair
主要	zhǔyào	main, chief, principal, major
主意	zhǔyì	idea, plan, decision, definite view
字典	zìdiǎn	dictionary, thesaurus
資料	zīliào	data
自由	zìyóu	freedom, liberty
自由	zìyóu	to be free, to be unrestrained
總統	zǒngtǒng	president
最好	zuìhǎo	had better, it would be best
最後	zuìhòu	finally, in the end/  the very last
左手	zuǒshǒu	left hand
做事	zuòshì	to take care of things, to do tihins, to do work
冰塊兒	bīngkuàiér	ice cube
不要緊	búyàojǐn	unimportant, never mind
不得了	bùdéliăo	to be extremely, to be exceedingly
差不多	chàbúduō	be similar to, be about the same…
好好兒	hǎohǎo	érin perfectly good condition
開玩笑	kāiwánxiào	to joke; to make fun of
禮拜日	lǐbàirì	Sunday
禮拜天	lǐbàitiān	Sunday
沒什麼	méisheme	nothing important; not bad; it is nothing to
沒事兒	méishì'ér	nothing important or exciting; all right
沒意思	méiyìsi	boring
明信片	míngxìnpiàn	postcard
男朋友	nánpéngyǒu	boyfriend
女朋友	nǚpéngyǒu	girlfriend
小朋友	xiǎopéngyǒu	children, little boy/ girl, childadult address to child
信用卡	xìnyòngkǎ	credit card
一點兒	yìdiǎnéra	bit of
一塊兒	yíkuàiér	together
部分/份	bùfèn/fèn	part, in part
差一點兒	chàyìdiănér	nearly
好久不見	hǎojiǔbújiàn	long time no see
老闆	lǎobǎn	boss, shopkeeper, proprietor
哪裡	nǎlǐ	what, how
其他	qítāothers,	the rest, other, else
十字路口	shízìlùkǒu	a crossroads, a crossing, an intersection, a crossing place
夜裡	yèlǐ	at night
大部分	dàbùfèn	most of, the majority of
一下子	yíxiàziin	a short while
